"","fish_id","bin","LLLL","LLLR","LLRL","LLRR","LRLL","LRLR","LRRL","LRRR","RLLL","RLLR","RLRL","RLRR","RRLL","RRLR","RRRL","RRRR","L","R","total_turns","reps","alts","rel_reps","rel_alts","rel_R","rel_L"
"1","1","1",11,8,11,9,12,30,11,6,8,12,32,8,8,10,6,6,100,91,191,17,62,8.90052356020942,32.4607329842932,47.6439790575916,52.3560209424084
"2","1","2",16,8,15,9,13,21,13,6,8,16,20,10,10,9,6,5,103,85,188,21,41,11.1702127659574,21.8085106382979,45.2127659574468,54.7872340425532
"3","1","3",6,9,12,6,14,15,7,7,9,9,17,8,4,10,7,11,78,76,154,17,32,11.038961038961,20.7792207792208,49.3506493506493,50.6493506493507
"4","1","4",19,11,15,7,12,22,12,6,11,11,19,11,10,9,7,2,105,82,187,21,41,11.2299465240642,21.9251336898396,43.8502673796791,56.1497326203209
"5","1","5",21,9,10,7,9,18,10,2,9,8,17,5,7,4,2,2,87,56,143,23,35,16.0839160839161,24.4755244755245,39.1608391608392,60.8391608391608
"6","1","6",6,9,9,6,7,27,10,3,8,6,26,7,7,6,3,1,79,65,144,7,53,4.86111111111111,36.8055555555556,45.1388888888889,54.8611111111111
"7","10","1",2,9,9,4,6,22,13,4,9,4,18,13,7,9,3,2,69,68,137,4,40,2.91970802919708,29.1970802919708,49.6350364963504,50.3649635036496
"8","10","2",2,5,7,2,5,14,5,4,5,4,13,7,4,5,4,6,46,49,95,8,27,8.42105263157895,28.4210526315789,51.5789473684211,48.4210526315789
"9","10","3",13,8,9,6,14,16,5,3,8,7,21,3,1,7,3,1,75,53,128,14,37,10.9375,28.90625,41.40625,58.59375
"10","10","4",11,8,8,5,6,3,8,4,7,5,2,7,6,6,4,6,55,44,99,17,5,17.1717171717172,5.05050505050505,44.4444444444444,55.5555555555556
"11","10","5",10,5,6,3,4,8,5,5,4,4,7,7,4,6,5,5,48,43,91,15,15,16.4835164835165,16.4835164835165,47.2527472527473,52.7472527472527
"12","10","6",5,3,5,5,6,2,6,1,3,6,3,3,3,4,1,0,34,25,59,5,5,8.47457627118644,8.47457627118644,42.3728813559322,57.6271186440678
"13","100","1",12,9,8,9,8,12,9,11,9,8,12,11,9,11,11,8,79,81,160,20,24,12.5,15,50.625,49.375
"14","100","2",2,2,4,5,6,15,6,8,3,7,17,8,4,10,8,7,51,64,115,9,32,7.82608695652174,27.8260869565217,55.6521739130435,44.3478260869565
"15","100","3",2,2,5,5,3,13,9,5,2,8,11,9,6,7,4,10,44,60,104,12,24,11.5384615384615,23.0769230769231,57.6923076923077,42.3076923076923
"16","100","4",2,5,6,3,7,21,8,2,5,4,23,6,2,8,2,3,56,54,110,5,44,4.54545454545455,40,49.0909090909091,50.9090909090909
"17","100","5",0,1,5,0,3,49,1,2,1,4,47,3,1,2,2,1,62,63,125,1,96,0.8,76.8,50.4,49.6
"18","100","6",4,8,12,2,13,14,6,1,8,6,14,5,1,6,1,0,61,43,104,4,28,3.84615384615385,26.9230769230769,41.3461538461538,58.6538461538462
"19","101","1",7,7,11,8,9,21,12,4,7,12,19,7,10,6,4,7,80,74,154,14,40,9.09090909090909,25.974025974026,48.0519480519481,51.9480519480519
"20","101","2",17,9,14,7,18,8,7,2,9,12,12,2,3,5,2,1,83,48,131,18,20,13.7404580152672,15.2671755725191,36.6412213740458,63.3587786259542
"21","101","3",26,12,8,9,10,12,13,3,12,5,14,6,7,8,3,3,94,60,154,29,26,18.8311688311688,16.8831168831169,38.961038961039,61.038961038961
"22","101","4",5,5,12,5,11,12,9,3,5,12,11,7,6,6,3,3,64,54,118,8,23,6.77966101694915,19.4915254237288,45.7627118644068,54.2372881355932
"23","101","5",1,4,9,6,12,29,7,4,5,11,32,5,4,7,4,5,75,73,148,6,61,4.05405405405405,41.2162162162162,49.3243243243243,50.6756756756757
"24","101","6",13,8,11,2,10,35,6,1,8,6,33,5,4,3,1,0,88,61,149,13,68,8.7248322147651,45.6375838926174,40.9395973154362,59.0604026845638
"25","102","1",17,8,12,9,11,15,10,11,8,12,14,12,9,12,11,14,94,94,188,31,29,16.4893617021277,15.4255319148936,50,50
"26","102","2",6,7,6,11,6,11,14,11,7,9,11,15,10,15,11,25,73,105,178,31,22,17.4157303370787,12.3595505617978,58.9887640449438,41.0112359550562
"27","102","3",0,2,3,2,2,16,11,16,2,3,16,25,3,24,16,20,54,110,164,20,32,12.1951219512195,19.5121951219512,67.0731707317073,32.9268292682927
"28","102","4",0,3,3,5,5,27,15,5,3,5,30,14,3,17,5,2,65,80,145,2,57,1.37931034482759,39.3103448275862,55.1724137931034,44.8275862068966
"29","102","5",0,2,1,1,2,52,13,2,2,0,53,14,0,15,2,0,74,88,162,0,105,0,64.8148148148148,54.320987654321,45.679012345679
"30","102","6",0,1,4,3,4,47,8,4,1,6,47,9,3,9,4,2,73,82,155,2,94,1.29032258064516,60.6451612903226,52.9032258064516,47.0967741935484
"31","11","1",33,21,17,9,18,14,7,8,21,4,15,6,8,7,8,10,129,80,209,43,29,20.5741626794258,13.8755980861244,38.2775119617225,61.7224880382775
"32","11","2",13,12,9,13,10,16,12,9,12,9,17,8,11,10,9,2,95,80,175,15,33,8.57142857142857,18.8571428571429,45.7142857142857,54.2857142857143
"33","11","3",16,13,13,10,13,7,8,5,13,10,8,2,10,3,5,4,87,56,143,20,15,13.986013986014,10.4895104895105,39.1608391608392,60.8391608391608
"34","11","4",13,9,9,4,9,15,4,4,9,4,14,4,4,3,3,3,67,47,114,16,29,14.0350877192982,25.4385964912281,41.2280701754386,58.7719298245614
"35","11","5",20,7,10,3,11,11,5,5,7,6,13,7,2,8,5,5,74,54,128,25,24,19.53125,18.75,42.1875,57.8125
"36","11","6",4,5,6,8,8,8,8,6,5,9,10,7,6,8,6,4,54,57,111,8,18,7.20720720720721,16.2162162162162,51.3513513513514,48.6486486486486
"37","12","1",11,12,11,12,9,12,15,13,12,11,10,16,13,14,12,6,95,97,192,17,22,8.85416666666667,11.4583333333333,50.5208333333333,49.4791666666667
"38","12","2",11,7,11,5,11,21,8,11,6,9,22,14,4,15,11,13,87,95,182,24,43,13.1868131868132,23.6263736263736,52.1978021978022,47.8021978021978
"39","12","3",2,3,1,4,4,15,3,8,4,2,18,7,2,10,9,13,43,65,108,15,33,13.8888888888889,30.5555555555556,60.1851851851852,39.8148148148148
"40","12","4",6,5,5,3,3,10,4,5,4,3,8,6,5,4,5,14,43,50,93,20,18,21.505376344086,19.3548387096774,53.7634408602151,46.2365591397849
"41","12","5",0,0,3,2,2,14,5,3,0,5,13,6,3,5,4,8,30,46,76,8,27,10.5263157894737,35.5263157894737,60.5263157894737,39.4736842105263
"42","12","6",0,0,2,0,0,16,2,0,0,2,13,2,2,0,0,0,21,21,42,0,29,0,69.0476190476191,50,50
"43","13","1",3,6,13,8,12,30,12,17,6,15,30,21,8,21,17,9,103,128,231,12,60,5.19480519480519,25.974025974026,55.4112554112554,44.5887445887446
"44","13","2",12,9,11,7,13,30,7,10,9,9,31,10,5,12,10,7,100,95,195,19,61,9.74358974358974,31.2820512820513,48.7179487179487,51.2820512820513
"45","13","3",5,7,7,11,4,20,15,8,7,11,17,12,14,8,8,6,78,85,163,11,37,6.74846625766871,22.6993865030675,52.1472392638037,47.8527607361963
"46","13","4",1,5,6,5,6,15,3,10,5,5,15,8,4,8,10,23,52,80,132,24,30,18.1818181818182,22.7272727272727,60.6060606060606,39.3939393939394
"47","13","5",3,3,3,5,1,5,6,12,3,5,4,12,7,11,12,19,40,74,114,22,9,19.2982456140351,7.89473684210526,64.9122807017544,35.0877192982456
"48","13","6",7,4,3,5,3,3,7,3,4,5,3,5,6,5,4,5,37,38,75,12,6,16,8,50.6666666666667,49.3333333333333
"49","14","1",4,3,11,6,7,31,18,6,3,14,27,18,11,14,6,10,88,104,192,14,58,7.29166666666667,30.2083333333333,54.1666666666667,45.8333333333333
"50","14","2",1,3,9,3,7,43,8,9,3,9,41,14,5,12,9,7,85,101,186,8,84,4.3010752688172,45.1612903225806,54.3010752688172,45.6989247311828
"51","14","3",9,6,9,8,9,12,12,15,6,10,13,19,7,20,15,25,82,116,198,34,25,17.1717171717172,12.6262626262626,58.5858585858586,41.4141414141414
"52","14","4",4,8,11,4,8,16,3,12,8,7,13,12,7,8,12,30,67,99,166,34,29,20.4819277108434,17.4698795180723,59.6385542168675,40.3614457831325
"53","14","5",7,7,11,5,12,21,3,9,8,9,22,6,5,7,9,8,78,74,152,15,43,9.86842105263158,28.2894736842105,48.6842105263158,51.3157894736842
"54","14","6",2,5,7,8,8,10,8,11,4,11,11,11,7,12,11,7,61,75,136,9,21,6.61764705882353,15.4411764705882,55.1470588235294,44.8529411764706
"55","15","1",3,10,9,8,7,16,15,9,10,8,14,15,11,13,9,5,79,86,165,8,30,4.84848484848485,18.1818181818182,52.1212121212121,47.8787878787879
"56","15","2",8,5,10,6,9,17,13,9,5,11,16,16,6,16,9,6,78,87,165,14,33,8.48484848484848,20,52.7272727272727,47.2727272727273
"57","15","3",0,0,1,3,1,14,4,18,0,4,13,19,3,18,18,30,42,107,149,30,27,20.1342281879195,18.1208053691275,71.8120805369127,28.1879194630872
"58","15","4",0,2,1,5,3,12,3,5,2,4,14,4,3,6,6,5,32,46,78,5,26,6.41025641025641,33.3333333333333,58.974358974359,41.025641025641
"59","15","5",1,2,3,3,3,12,3,2,2,4,12,2,2,3,2,1,30,30,60,2,24,3.33333333333333,40,50,50
"60","15","6",0,0,1,0,1,11,1,0,0,1,10,1,0,1,0,0,15,15,30,0,21,0,70,50,50
"61","16","1",5,8,7,5,6,8,9,8,8,4,7,12,6,11,8,7,57,65,122,12,15,9.83606557377049,12.2950819672131,53.2786885245902,46.7213114754098
"62","16","2",2,2,2,3,3,12,5,6,2,3,13,8,2,9,7,4,36,50,86,6,25,6.97674418604651,29.0697674418605,58.1395348837209,41.8604651162791
"63","16","3",3,3,4,3,1,12,6,7,3,4,9,10,6,7,7,11,40,59,99,14,21,14.1414141414141,21.2121212121212,59.5959595959596,40.4040404040404
"64","16","4",1,3,5,3,5,11,2,4,3,4,11,3,3,3,4,2,36,34,70,3,22,4.28571428571429,31.4285714285714,48.5714285714286,51.4285714285714
"65","16","5",8,8,8,4,5,13,7,4,9,4,10,7,7,4,4,8,60,53,113,16,23,14.1592920353982,20.353982300885,46.9026548672566,53.0973451327434
"66","16","6",5,3,4,3,6,8,7,3,3,5,9,7,2,8,3,2,41,40,81,7,17,8.64197530864197,20.9876543209877,49.3827160493827,50.6172839506173
"67","19","1",2,2,3,6,5,10,6,11,2,7,11,11,4,13,11,11,46,72,118,13,21,11.0169491525424,17.7966101694915,61.0169491525424,38.9830508474576
"68","19","2",4,6,5,5,5,14,9,6,6,4,14,10,5,10,6,7,56,63,119,11,28,9.2436974789916,23.5294117647059,52.9411764705882,47.0588235294118
"69","19","3",0,3,5,4,6,7,7,7,3,6,9,9,3,11,7,13,41,62,103,13,16,12.621359223301,15.5339805825243,60.1941747572816,39.8058252427184
"70","19","4",1,6,4,6,4,6,4,8,6,4,6,7,6,7,9,20,40,67,107,21,12,19.6261682242991,11.214953271028,62.6168224299065,37.3831775700935
"71","19","5",2,2,3,3,6,9,5,4,2,4,11,6,0,8,3,6,34,43,77,8,20,10.3896103896104,25.974025974026,55.8441558441558,44.1558441558442
"72","19","6",1,3,1,6,4,2,6,3,3,5,5,3,4,6,4,4,28,35,63,5,7,7.93650793650794,11.1111111111111,55.5555555555556,44.4444444444444
"73","2","1",7,5,12,6,13,13,6,8,5,13,13,8,6,8,8,7,72,69,141,14,26,9.9290780141844,18.4397163120567,48.936170212766,51.063829787234
"74","2","2",10,7,6,9,4,8,15,10,7,8,6,16,11,14,10,11,72,83,155,21,14,13.5483870967742,9.03225806451613,53.5483870967742,46.4516129032258
"75","2","3",5,10,12,11,10,14,14,8,10,13,12,11,14,8,8,6,86,83,169,11,26,6.50887573964497,15.3846153846154,49.112426035503,50.887573964497
"76","2","4",13,13,9,7,11,17,9,7,14,3,19,9,6,10,7,2,89,70,159,15,36,9.43396226415094,22.6415094339623,44.0251572327044,55.9748427672956
"77","2","5",11,6,10,2,6,25,4,10,6,6,20,12,6,7,9,18,74,87,161,29,45,18.0124223602484,27.9503105590062,54.0372670807453,45.9627329192547
"78","2","6",1,4,3,7,4,32,11,5,4,6,33,9,6,10,4,6,67,81,148,7,65,4.72972972972973,43.9189189189189,54.7297297297297,45.2702702702703
"79","20","1",1,3,7,7,5,14,11,8,3,11,12,11,9,9,7,3,56,68,124,4,26,3.2258064516129,20.9677419354839,54.8387096774194,45.1612903225806
"80","20","2",2,5,3,10,5,2,10,6,5,9,4,6,9,8,7,6,45,55,100,8,6,8,6,55,45
"81","20","3",3,4,5,2,5,16,4,3,4,3,17,5,2,6,4,0,44,42,86,3,33,3.48837209302326,38.3720930232558,48.8372093023256,51.1627906976744
"82","20","4",15,10,12,4,14,12,5,3,10,6,14,5,2,7,4,5,76,55,131,20,26,15.2671755725191,19.8473282442748,41.9847328244275,58.0152671755725
"83","20","5",0,1,1,1,1,10,3,11,1,1,9,13,1,13,11,11,29,62,91,11,19,12.0879120879121,20.8791208791209,68.1318681318681,31.8681318681319
"84","20","6",0,1,3,2,1,4,5,7,1,4,2,10,3,8,6,6,23,43,66,6,6,9.09090909090909,9.09090909090909,65.1515151515152,34.8484848484849
"85","200","1",4,4,8,9,6,31,18,8,3,13,30,17,10,16,8,4,90,102,192,8,61,4.16666666666667,31.7708333333333,53.125,46.875
"86","200","2",2,2,11,3,11,25,6,2,2,12,26,5,3,5,2,3,64,59,123,5,51,4.0650406504065,41.4634146341463,47.9674796747967,52.0325203252033
"87","200","3",1,1,9,2,10,24,8,0,1,10,25,6,1,7,0,0,57,51,108,1,49,0.925925925925926,45.3703703703704,47.2222222222222,52.7777777777778
"88","200","4",0,0,4,1,2,13,5,5,0,5,11,8,3,6,4,4,30,44,74,4,24,5.40540540540541,32.4324324324324,59.4594594594595,40.5405405405405
"89","200","5",1,1,4,4,5,26,6,4,1,7,27,7,3,7,4,1,52,59,111,2,53,1.8018018018018,47.7477477477477,53.1531531531532,46.8468468468468
"90","200","6",2,6,7,7,10,1965,6,10,6,8,1967,9,4,12,10,23,2014,2041,4055,25,3932,0.61652281134402,96.9667077681874,50.3329223181258,49.6670776818742
"91","21","1",4,3,4,8,7,11,7,13,3,9,15,11,5,15,13,29,59,101,160,33,26,20.625,16.25,63.125,36.875
"92","21","2",9,9,10,5,10,12,7,18,9,6,12,21,5,21,18,51,81,145,226,60,24,26.5486725663717,10.6194690265487,64.1592920353982,35.8407079646018
"93","21","3",3,9,13,11,14,15,11,13,9,16,16,13,10,14,13,21,91,113,204,24,31,11.7647058823529,15.1960784313725,55.3921568627451,44.6078431372549
"94","21","4",5,8,8,7,8,11,4,18,8,7,11,15,7,15,17,36,69,119,188,41,22,21.8085106382979,11.7021276595745,63.2978723404255,36.7021276595745
"95","21","5",5,12,12,11,12,15,6,18,12,11,15,13,12,13,19,34,93,130,223,39,30,17.4887892376682,13.4529147982063,58.2959641255605,41.7040358744395
"96","21","6",15,12,9,17,9,8,6,17,11,14,8,6,16,7,17,77,94,158,252,92,16,36.5079365079365,6.34920634920635,62.6984126984127,37.3015873015873
"97","22","1",8,5,11,4,12,9,6,3,5,10,10,5,4,6,4,7,60,52,112,15,19,13.3928571428571,16.9642857142857,46.4285714285714,53.5714285714286
"98","22","2",1,6,10,3,8,22,7,8,6,7,20,13,5,10,8,4,66,75,141,5,42,3.54609929078014,29.7872340425532,53.1914893617021,46.8085106382979
"99","22","3",7,8,7,6,4,10,5,9,8,6,7,8,10,4,9,11,58,64,122,18,17,14.7540983606557,13.9344262295082,52.4590163934426,47.5409836065574
"100","22","4",4,5,5,5,7,3,5,3,6,5,4,3,4,4,3,6,40,35,75,10,7,13.3333333333333,9.33333333333333,46.6666666666667,53.3333333333333
"101","22","5",9,5,3,4,3,5,3,4,4,2,5,3,4,3,4,2,38,28,66,11,10,16.6666666666667,15.1515151515152,42.4242424242424,57.5757575757576
"102","22","6",5,2,0,4,0,0,4,4,2,1,0,4,3,4,4,6,20,26,46,11,0,23.9130434782609,0,56.5217391304348,43.4782608695652
"103","23","1",6,18,19,10,21,16,13,4,18,12,18,7,8,9,4,0,109,77,186,6,34,3.2258064516129,18.2795698924731,41.3978494623656,58.6021505376344
"104","23","2",3,7,13,4,12,35,7,6,7,10,35,8,5,8,6,2,89,82,171,5,70,2.92397660818713,40.9356725146199,47.953216374269,52.046783625731
"105","23","3",13,9,11,6,11,16,10,2,9,8,15,7,6,6,2,1,79,56,135,14,31,10.3703703703704,22.962962962963,41.4814814814815,58.5185185185185
"106","23","4",5,5,6,4,2,12,11,8,5,5,8,15,8,11,8,2,55,63,118,7,20,5.93220338983051,16.9491525423729,53.3898305084746,46.6101694915254
"107","23","5",11,14,18,4,16,7,3,8,14,8,6,6,6,5,8,2,83,56,139,13,13,9.35251798561151,9.35251798561151,40.2877697841727,59.7122302158273
"108","23","6",15,10,14,2,11,21,7,4,10,6,18,8,6,5,4,4,86,62,148,19,39,12.8378378378378,26.3513513513514,41.8918918918919,58.1081081081081
"109","24","1",20,10,10,5,8,5,6,6,10,5,3,7,7,6,6,6,71,52,123,26,8,21.1382113821138,6.50406504065041,42.2764227642276,57.7235772357724
"110","24","2",14,9,14,3,12,12,5,4,8,8,10,6,5,4,4,4,75,50,125,18,22,14.4,17.6,40,60
"111","24","3",3,5,8,6,6,18,9,4,5,8,16,7,7,6,4,6,60,61,121,9,34,7.43801652892562,28.099173553719,50.4132231404959,49.5867768595041
"112","24","4",15,9,9,6,9,6,7,4,8,6,6,5,5,6,4,3,66,45,111,18,12,16.2162162162162,10.8108108108108,40.5405405405405,59.4594594594595
"113","24","5",4,5,8,2,7,16,2,5,5,5,14,5,3,3,5,2,50,44,94,6,30,6.38297872340426,31.9148936170213,46.8085106382979,53.1914893617021
"114","24","6",41,10,11,3,11,8,3,0,11,4,8,0,3,0,0,0,90,26,116,41,16,35.3448275862069,13.7931034482759,22.4137931034483,77.5862068965517
"115","25","1",1,1,1,2,3,3,3,4,2,2,5,4,1,6,4,9,21,33,54,10,8,18.5185185185185,14.8148148148148,61.1111111111111,38.8888888888889
"116","25","2",0,1,3,4,4,15,4,6,1,6,17,5,3,7,6,2,39,48,87,2,32,2.29885057471264,36.7816091954023,55.1724137931034,44.8275862068966
"117","25","3",0,0,1,0,0,32,2,1,0,1,32,3,1,2,1,3,38,44,82,3,64,3.65853658536585,78.0487804878049,53.6585365853659,46.3414634146341
"118","25","4",0,0,0,0,0,17,0,1,0,0,18,1,0,1,1,1,20,23,43,1,35,2.32558139534884,81.3953488372093,53.4883720930233,46.5116279069767
"119","25","5",0,0,0,0,0,1,0,0,0,0,2,0,0,0,0,0,3,3,6,0,3,0,50,50,50
"120","25","6",0,0,0,1,0,1,1,0,0,1,2,0,0,1,0,0,5,5,10,0,3,0,30,50,50
"121","26","1",1,1,1,0,0,1,0,1,1,1,0,1,1,0,1,17,7,23,30,18,1,60,3.33333333333333,76.6666666666667,23.3333333333333
"122","26","2",0,0,0,2,2,3,3,3,0,2,5,3,0,6,3,8,14,29,43,8,8,18.6046511627907,18.6046511627907,67.4418604651163,32.5581395348837
"123","26","3",0,0,0,0,0,3,2,2,0,0,3,5,0,5,3,18,8,36,44,18,6,40.9090909090909,13.6363636363636,81.8181818181818,18.1818181818182
"124","26","4",0,1,0,1,1,3,0,2,1,0,5,1,0,3,2,7,10,20,30,7,8,23.3333333333333,26.6666666666667,66.6666666666667,33.3333333333333
"125","26","5",0,0,0,0,0,0,0,1,0,0,0,1,0,1,2,14,2,20,22,14,0,63.6363636363636,0,90.9090909090909,9.09090909090909
"126","26","6",0,0,1,0,0,2,0,3,0,1,1,3,1,2,2,10,6,23,29,10,3,34.4827586206897,10.3448275862069,79.3103448275862,20.6896551724138
"127","27","1",6,8,13,8,16,29,10,2,7,13,32,4,5,7,2,2,94,73,167,8,61,4.79041916167665,36.5269461077844,43.7125748502994,56.2874251497006
"128","27","2",5,7,8,7,8,12,4,10,7,9,12,6,8,6,10,20,63,79,142,25,24,17.6056338028169,16.9014084507042,55.6338028169014,44.3661971830986
"129","27","3",0,1,2,2,4,20,2,1,1,3,23,1,0,4,2,1,34,36,70,1,43,1.42857142857143,61.4285714285714,51.4285714285714,48.5714285714286
"130","27","4",4,3,2,3,5,17,3,0,3,2,21,0,0,3,0,0,39,30,69,4,38,5.79710144927536,55.0724637681159,43.4782608695652,56.5217391304348
"131","27","5",1,1,1,2,2,12,2,0,1,2,14,0,0,2,0,0,23,20,43,1,26,2.32558139534884,60.4651162790698,46.5116279069767,53.4883720930233
"132","27","6",0,1,2,1,3,9,1,0,1,2,10,0,0,1,0,0,18,16,34,0,19,0,55.8823529411765,47.0588235294118,52.9411764705882
"133","28","1",5,3,4,4,1,10,7,8,3,5,7,10,7,8,8,14,43,64,107,19,17,17.7570093457944,15.8878504672897,59.8130841121495,40.1869158878505
"134","28","2",0,0,1,5,2,54,6,10,0,6,55,11,4,12,10,25,79,125,204,25,109,12.2549019607843,53.4313725490196,61.2745098039216,38.7254901960784
"135","28","3",2,1,1,2,2,41,3,11,1,2,42,12,2,12,11,14,65,97,162,16,83,9.87654320987654,51.2345679012346,59.8765432098765,40.1234567901235
"136","28","4",0,0,0,5,2,23,5,12,0,5,26,12,3,15,12,30,49,104,153,30,49,19.6078431372549,32.0261437908497,67.9738562091503,32.0261437908497
"137","28","5",0,0,2,2,4,25,4,3,0,4,28,5,0,8,4,4,42,54,96,4,53,4.16666666666667,55.2083333333333,56.25,43.75
"138","28","6",0,1,3,2,2,3,4,1,1,4,1,3,4,1,1,1,18,17,35,1,4,2.85714285714286,11.4285714285714,48.5714285714286,51.4285714285714
"139","29","1",14,15,14,6,15,23,6,4,15,5,25,4,5,6,5,0,99,66,165,14,48,8.48484848484848,29.0909090909091,40,60
"140","29","2",15,10,10,5,12,19,6,0,10,5,21,1,4,3,0,0,79,45,124,15,40,12.0967741935484,32.258064516129,36.2903225806452,63.7096774193548
"141","29","3",15,9,14,3,14,14,6,1,9,7,14,4,3,4,1,1,78,44,122,16,28,13.1147540983607,22.9508196721311,36.0655737704918,63.9344262295082
"142","29","4",8,4,4,1,4,9,1,0,5,1,9,0,2,0,0,0,34,17,51,8,18,15.6862745098039,35.2941176470588,33.3333333333333,66.6666666666667
"143","29","5",15,6,8,2,6,6,3,0,6,3,5,1,3,0,0,0,48,19,67,15,11,22.3880597014925,16.4179104477612,28.3582089552239,71.6417910447761
"144","29","6",13,4,4,0,4,5,0,0,3,0,5,0,0,0,0,0,32,9,41,13,10,31.7073170731707,24.390243902439,21.9512195121951,78.0487804878049
"145","30","1",1,1,5,5,4,8,8,3,1,9,7,6,7,5,4,3,37,43,80,4,15,5,18.75,53.75,46.25
"146","30","2",5,3,9,0,8,11,2,0,3,6,10,2,1,1,0,0,39,25,64,5,21,7.8125,32.8125,39.0625,60.9375
"147","30","3",4,5,6,2,5,7,5,0,5,3,6,3,3,2,0,0,37,22,59,4,13,6.77966101694915,22.0338983050847,37.2881355932203,62.7118644067797
"148","30","4",3,3,5,0,5,1,2,1,3,3,1,3,0,3,1,0,22,15,37,3,2,8.10810810810811,5.40540540540541,40.5405405405405,59.4594594594595
"149","30","5",4,3,2,1,3,0,1,0,3,0,0,0,0,0,0,0,15,5,20,4,0,20,0,25,75
"150","30","6",7,4,4,0,3,8,0,0,4,0,8,0,0,0,0,0,28,13,41,7,16,17.0731707317073,39.0243902439024,31.7073170731707,68.2926829268293
"151","31","1",3,1,6,2,5,23,6,5,2,6,22,9,3,8,5,7,54,62,116,10,45,8.62068965517241,38.7931034482759,53.448275862069,46.551724137931
"152","31","2",3,2,5,6,10,39,5,4,2,9,43,3,2,7,4,1,76,72,148,4,82,2.7027027027027,55.4054054054054,48.6486486486486,51.3513513513514
"153","31","3",2,4,8,2,7,6,3,2,4,6,5,3,3,2,2,1,36,27,63,3,11,4.76190476190476,17.4603174603175,42.8571428571429,57.1428571428571
"154","31","4",4,3,2,2,2,6,3,5,3,1,5,6,2,5,5,9,28,38,66,13,11,19.6969696969697,16.6666666666667,57.5757575757576,42.4242424242424
"155","31","5",0,0,2,2,1,6,5,3,0,3,5,6,2,6,3,4,20,31,51,4,11,7.84313725490196,21.5686274509804,60.7843137254902,39.2156862745098
"156","31","6",4,4,4,0,2,4,2,2,4,0,2,3,3,1,2,10,24,26,50,14,6,28,12,52,48
"157","32","1",2,4,3,3,2,4,2,4,4,1,3,3,3,2,4,5,25,27,52,7,7,13.4615384615385,13.4615384615385,51.9230769230769,48.0769230769231
"158","32","2",2,2,2,3,2,12,2,3,2,3,13,2,3,2,3,1,30,30,60,3,25,5,41.6666666666667,50,50
"159","32","3",4,2,3,3,1,5,5,4,2,4,3,5,6,3,4,7,29,35,64,11,8,17.1875,12.5,54.6875,45.3125
"160","32","4",1,1,1,3,2,0,2,5,1,3,1,4,1,5,5,5,16,27,43,6,1,13.953488372093,2.32558139534884,62.7906976744186,37.2093023255814
"161","32","5",0,2,0,4,2,0,2,4,1,3,2,2,2,4,4,10,16,29,45,10,2,22.2222222222222,4.44444444444444,64.4444444444444,35.5555555555556
"162","32","6",0,1,3,0,1,4,0,4,1,2,2,4,1,2,3,4,13,22,35,4,6,11.4285714285714,17.1428571428571,62.8571428571429,37.1428571428571
"163","33","1",0,2,6,3,7,96,9,8,2,7,98,13,2,15,8,4,133,150,283,4,194,1.41342756183746,68.5512367491166,53.0035335689046,46.9964664310954
"164","33","2",3,3,7,2,8,212,5,3,4,6,213,6,2,7,3,0,246,241,487,3,425,0.616016427104723,87.2689938398357,49.4866529774127,50.5133470225873
"165","33","3",0,0,0,2,0,0,4,1,0,2,0,4,2,4,2,0,8,16,24,0,0,0,0,66.6666666666667,33.3333333333333
"166","33","4",4,3,2,1,2,6,2,2,3,0,6,2,1,2,2,1,23,19,42,5,12,11.9047619047619,28.5714285714286,45.2380952380952,54.7619047619048
"167","33","5",2,4,1,3,3,1,3,1,4,0,3,1,1,3,1,1,19,16,35,3,4,8.57142857142857,11.4285714285714,45.7142857142857,54.2857142857143
"168","33","6",0,1,2,1,2,11,1,2,1,3,11,2,2,2,3,1,22,26,48,1,22,2.08333333333333,45.8333333333333,54.1666666666667,45.8333333333333
"169","34","1",13,5,2,5,3,3,3,4,4,2,4,2,3,3,3,2,38,26,64,15,7,23.4375,10.9375,40.625,59.375
"170","34","2",1,3,1,5,2,2,4,5,4,3,3,4,5,4,5,7,26,35,61,8,5,13.1147540983607,8.19672131147541,57.3770491803279,42.6229508196721
"171","34","3",0,1,5,5,9,8,5,4,1,9,11,4,1,7,3,2,37,41,78,2,19,2.56410256410256,24.3589743589744,52.5641025641026,47.4358974358974
"172","34","4",1,4,7,1,5,9,3,2,5,4,6,4,4,1,2,0,35,26,61,1,15,1.63934426229508,24.5901639344262,42.6229508196721,57.3770491803279
"173","34","5",6,5,4,3,6,5,3,2,4,2,7,2,0,4,1,6,34,29,63,12,12,19.047619047619,19.047619047619,46.031746031746,53.968253968254
"174","34","6",0,1,4,2,4,2,3,2,1,4,3,3,1,4,2,4,20,23,43,4,5,9.30232558139535,11.6279069767442,53.4883720930233,46.5116279069767
"175","35","1",1,2,4,1,4,157,2,2,2,3,158,3,1,3,2,1,175,174,349,2,315,0.573065902578797,90.2578796561605,49.8567335243553,50.1432664756447
"176","35","2",0,0,9,0,9,523,10,1,0,9,522,11,0,11,1,0,553,556,1109,0,1045,0,94.229035166817,50.1352569882777,49.8647430117223
"177","35","3",0,0,5,1,6,321,7,0,0,6,322,6,0,7,0,0,342,342,684,0,643,0,94.0058479532164,50,50
"178","35","4",0,3,4,1,5,23,2,1,3,2,24,2,1,3,2,0,41,38,79,0,47,0,59.4936708860759,48.1012658227848,51.8987341772152
"179","35","5",1,1,1,1,1,3,1,2,1,1,3,2,0,3,2,2,12,16,28,3,6,10.7142857142857,21.4285714285714,57.1428571428571,42.8571428571429
"180","35","6",0,0,0,0,0,2,1,3,0,0,2,3,0,3,2,2,6,15,21,2,4,9.52380952380952,19.047619047619,71.4285714285714,28.5714285714286
"181","38","1",10,8,15,6,13,18,8,5,8,13,16,7,8,5,5,4,84,68,152,14,34,9.21052631578947,22.3684210526316,44.7368421052632,55.2631578947368
"182","38","2",7,7,11,8,14,14,13,3,7,12,17,8,5,11,3,3,79,67,146,10,31,6.84931506849315,21.2328767123288,45.8904109589041,54.1095890410959
"183","38","3",0,3,10,4,9,16,6,4,3,11,16,6,5,5,4,0,54,51,105,0,32,0,30.4761904761905,48.5714285714286,51.4285714285714
"184","38","4",9,7,13,6,7,17,11,2,7,11,12,7,11,2,2,0,74,53,127,9,29,7.08661417322835,22.8346456692913,41.7322834645669,58.2677165354331
"185","38","5",6,9,12,6,13,9,7,6,9,9,10,7,6,7,6,1,70,56,126,7,19,5.55555555555556,15.0793650793651,44.4444444444444,55.5555555555556
"186","38","6",2,4,10,10,14,19,12,0,4,16,24,2,5,7,0,0,73,59,132,2,43,1.51515151515152,32.5757575757576,44.6969696969697,55.3030303030303
"187","39","1",8,10,10,10,11,23,15,7,10,10,24,13,9,14,8,11,95,101,196,19,47,9.69387755102041,23.9795918367347,51.530612244898,48.469387755102
"188","39","2",12,14,17,8,17,16,8,3,14,11,16,3,8,4,3,4,96,65,161,16,32,9.93788819875776,19.8757763975155,40.3726708074534,59.6273291925466
"189","39","3",16,10,15,2,13,19,4,4,10,7,16,6,4,4,4,1,84,54,138,17,35,12.3188405797101,25.3623188405797,39.1304347826087,60.8695652173913
"190","39","4",3,5,7,5,8,17,9,2,5,7,18,5,5,6,2,0,58,49,107,3,35,2.80373831775701,32.7102803738318,45.7943925233645,54.2056074766355
"191","39","5",8,6,8,7,8,9,7,6,6,9,8,6,7,6,6,4,60,54,114,12,17,10.5263157894737,14.9122807017544,47.3684210526316,52.6315789473684
"192","39","6",5,4,9,2,10,12,4,3,4,8,13,5,2,6,4,5,51,48,99,10,25,10.1010101010101,25.2525252525253,48.4848484848485,51.5151515151515
"193","40","1",16,12,13,8,15,20,10,4,12,9,21,6,6,7,3,4,98,71,169,20,41,11.8343195266272,24.2603550295858,42.0118343195266,57.9881656804734
"194","40","2",11,7,7,8,9,17,8,5,7,8,19,5,6,7,5,4,73,63,136,15,36,11.0294117647059,26.4705882352941,46.3235294117647,53.6764705882353
"195","40","3",6,8,15,3,9,22,10,6,8,10,16,14,8,8,6,3,80,75,155,9,38,5.80645161290323,24.5161290322581,48.3870967741936,51.6129032258064
"196","40","4",3,5,5,4,6,14,7,7,5,4,15,10,3,11,8,11,52,69,121,14,29,11.5702479338843,23.9669421487603,57.0247933884297,42.9752066115703
"197","40","5",3,6,4,9,7,19,9,4,6,7,22,4,5,8,4,5,62,63,125,8,41,6.4,32.8,50.4,49.6
"198","40","6",1,3,8,6,5,19,10,4,3,10,16,9,8,6,4,8,57,66,123,9,35,7.31707317073171,28.4552845528455,53.6585365853659,46.3414634146341
"199","41","1",25,9,14,4,12,11,3,6,10,9,9,4,7,2,6,8,87,55,142,33,20,23.2394366197183,14.0845070422535,38.7323943661972,61.2676056338028
"200","41","2",19,13,17,4,17,6,5,0,13,8,6,1,4,1,0,0,83,34,117,19,12,16.2393162393162,10.2564102564103,29.0598290598291,70.9401709401709
"201","41","3",12,9,18,1,18,9,1,0,8,10,10,0,0,1,0,0,70,30,100,12,19,12,19,30,70
"202","41","4",27,12,13,2,10,13,5,3,12,3,9,6,6,2,3,2,87,44,131,29,22,22.1374045801527,16.793893129771,33.587786259542,66.412213740458
"203","41","5",58,11,15,6,12,10,10,0,10,10,7,4,9,1,0,0,124,42,166,58,17,34.9397590361446,10.2409638554217,25.3012048192771,74.6987951807229
"204","41","6",68,14,16,3,16,10,3,0,13,5,11,0,2,1,0,0,132,33,165,68,21,41.2121212121212,12.7272727272727,20,80
"205","42","1",6,7,7,5,7,16,9,7,7,5,16,11,5,11,7,6,65,70,135,12,32,8.88888888888889,23.7037037037037,51.8518518518519,48.1481481481481
"206","42","2",14,8,6,9,9,20,10,8,8,7,23,9,6,12,8,3,86,77,163,17,43,10.4294478527607,26.3803680981595,47.239263803681,52.760736196319
"207","42","3",1,2,7,5,7,12,5,6,2,10,12,7,4,7,6,5,46,55,101,6,24,5.94059405940594,23.7623762376238,54.4554455445545,45.5445544554455
"208","42","4",0,1,2,2,2,3,2,1,1,2,3,1,1,1,0,0,13,12,25,0,6,0,24,48,52
"209","42","5",0,0,0,0,0,1,0,0,0,0,2,0,0,0,0,0,3,3,6,0,3,0,50,50,50
"210","42","6",0,0,0,0,0,7,0,0,0,0,8,0,0,0,0,0,9,9,18,0,15,0,83.3333333333333,50,50
"211","43","1",9,8,7,6,4,18,14,16,7,5,15,24,8,21,16,31,83,129,212,40,33,18.8679245283019,15.5660377358491,60.8490566037736,39.1509433962264
"212","43","2",13,9,12,12,12,26,13,18,9,15,26,19,12,19,18,17,116,137,253,30,52,11.8577075098814,20.5533596837945,54.1501976284585,45.8498023715415
"213","43","3",7,10,12,14,16,12,14,10,10,16,17,10,9,15,10,11,97,99,196,18,29,9.18367346938776,14.7959183673469,50.5102040816327,49.4897959183673
"214","43","4",3,3,3,3,5,61,2,2,3,3,64,1,1,4,2,2,84,81,165,5,125,3.03030303030303,75.7575757575758,49.0909090909091,50.9090909090909
"215","43","5",13,9,13,2,8,39,5,2,9,6,34,5,6,1,2,1,92,66,158,14,73,8.86075949367089,46.2025316455696,41.7721518987342,58.2278481012658
"216","43","6",7,7,9,4,9,21,8,2,7,6,20,7,4,6,2,0,68,54,122,7,41,5.73770491803279,33.6065573770492,44.2622950819672,55.7377049180328
"217","44","1",8,12,11,10,10,21,12,8,13,8,20,10,11,9,8,6,95,85,180,14,41,7.77777777777778,22.7777777777778,47.2222222222222,52.7777777777778
"218","44","2",2,8,2,8,5,9,7,11,8,2,13,10,5,14,12,21,54,86,140,23,22,16.4285714285714,15.7142857142857,61.4285714285714,38.5714285714286
"219","44","3",7,6,9,4,6,4,2,7,6,8,1,5,7,2,7,2,47,39,86,9,5,10.4651162790698,5.81395348837209,45.3488372093023,54.6511627906977
"220","44","4",1,4,4,2,4,10,4,5,4,2,10,7,2,7,5,4,35,43,78,5,20,6.41025641025641,25.6410256410256,55.1282051282051,44.8717948717949
"221","44","5",1,2,3,3,2,16,4,4,2,4,15,5,4,4,4,4,37,43,80,5,31,6.25,38.75,53.75,46.25
"222","44","6",1,2,7,1,3,11,5,1,1,6,7,6,4,2,1,1,32,30,62,2,18,3.2258064516129,29.0322580645161,48.3870967741936,51.6129032258064
"223","45","1",15,9,9,8,10,20,11,6,9,8,20,9,7,9,6,5,89,75,164,20,40,12.1951219512195,24.390243902439,45.7317073170732,54.2682926829268
"224","45","2",6,8,8,5,6,12,11,8,8,6,10,14,7,12,8,19,66,85,151,25,22,16.5562913907285,14.5695364238411,56.2913907284768,43.7086092715232
"225","45","3",2,5,3,7,6,7,4,9,5,5,9,6,4,9,9,4,44,53,97,6,16,6.18556701030928,16.4948453608247,54.639175257732,45.360824742268
"226","45","4",2,2,4,5,4,8,6,6,2,7,8,6,5,7,6,13,38,56,94,15,16,15.9574468085106,17.0212765957447,59.5744680851064,40.4255319148936
"227","45","5",6,2,2,3,3,16,7,3,3,3,16,7,3,7,3,3,45,45,90,9,32,10,35.5555555555556,50,50
"228","45","6",7,4,4,7,6,13,8,4,3,7,16,5,4,8,4,4,55,52,107,11,29,10.2803738317757,27.1028037383178,48.5981308411215,51.4018691588785
"229","46","1",3,4,4,4,7,22,4,4,4,4,26,4,1,7,4,3,54,54,108,6,48,5.55555555555556,44.4444444444444,50,50
"230","46","2",0,1,3,0,2,19,0,2,1,2,19,2,1,2,3,7,29,38,67,7,38,10.4477611940299,56.7164179104478,56.7164179104478,43.2835820895522
"231","46","3",0,0,1,0,0,35,1,0,0,1,35,1,1,0,0,0,39,39,78,0,70,0,89.7435897435897,50,50
"232","46","4",0,1,0,1,1,35,0,1,1,0,36,0,0,0,1,0,40,40,80,0,71,0,88.75,50,50
"233","46","5",2,2,5,2,6,31,4,1,2,5,33,3,1,4,1,2,55,52,107,4,64,3.73831775700935,59.8130841121495,48.5981308411215,51.4018691588785
"234","46","6",4,2,5,4,4,20,5,5,2,7,19,6,5,5,5,9,50,60,110,13,39,11.8181818181818,35.4545454545455,54.5454545454545,45.4545454545455
"235","47","1",0,0,0,0,0,0,0,0,0,0,0,0,0,0,0,0,1,1,2,0,0,0,0,50,50
"236","47","2",0,0,2,0,0,6,3,1,0,2,4,4,2,2,1,5,12,23,35,5,10,14.2857142857143,28.5714285714286,65.7142857142857,34.2857142857143
"237","47","3",9,3,6,0,4,18,6,2,3,3,17,8,1,7,2,1,50,43,93,10,35,10.752688172043,37.6344086021505,46.2365591397849,53.7634408602151
"238","47","4",22,11,13,2,14,16,2,0,11,4,18,0,1,2,0,0,82,37,119,22,34,18.4873949579832,28.5714285714286,31.0924369747899,68.9075630252101
"239","47","5",10,10,8,8,10,6,7,3,10,6,8,3,5,5,3,0,63,42,105,10,14,9.52380952380952,13.3333333333333,40,60
"240","47","6",20,6,4,5,4,7,5,0,6,3,7,1,4,1,0,0,52,24,76,20,14,26.3157894736842,18.4210526315789,31.5789473684211,68.4210526315789
"241","5","1",1,4,6,8,8,8,8,10,4,10,10,10,6,12,10,9,55,72,127,10,18,7.8740157480315,14.1732283464567,56.6929133858268,43.3070866141732
"242","5","2",6,8,3,14,3,11,12,10,8,9,11,8,14,8,10,18,68,88,156,24,22,15.3846153846154,14.1025641025641,56.4102564102564,43.5897435897436
"243","5","3",6,2,5,5,2,25,6,10,2,8,22,10,8,8,10,10,62,80,142,16,47,11.2676056338028,33.0985915492958,56.3380281690141,43.6619718309859
"244","5","4",3,2,2,4,1,7,4,10,2,4,6,10,4,10,10,18,34,66,100,21,13,21,13,66,34
"245","5","5",4,1,2,1,1,6,2,10,1,3,4,11,3,9,10,18,29,60,89,22,10,24.7191011235955,11.2359550561798,67.4157303370787,32.5842696629214
"246","5","6",0,1,4,2,3,9,5,2,1,4,9,5,2,5,2,1,28,30,58,1,18,1.72413793103448,31.0344827586207,51.7241379310345,48.2758620689655
"247","50","1",2,2,3,3,4,6,4,5,2,4,7,6,2,6,5,5,30,39,69,7,13,10.1449275362319,18.8405797101449,56.5217391304348,43.4782608695652
"248","50","2",1,2,5,2,3,11,6,4,2,5,9,8,4,6,4,8,36,47,83,9,20,10.8433734939759,24.0963855421687,56.6265060240964,43.3734939759036
"249","50","3",2,2,5,6,8,4,8,2,2,9,8,4,3,7,2,4,39,40,79,6,12,7.59493670886076,15.1898734177215,50.6329113924051,49.3670886075949
"250","50","4",7,3,3,3,6,16,3,0,4,3,19,0,1,2,0,0,44,29,73,7,35,9.58904109589041,47.9452054794521,39.7260273972603,60.2739726027397
"251","50","5",3,2,1,4,4,3,4,2,2,4,6,2,2,4,2,2,25,25,50,5,9,10,18,50,50
"252","50","6",2,3,4,2,3,1,2,0,3,3,0,0,2,0,0,0,18,10,28,2,1,7.14285714285714,3.57142857142857,35.7142857142857,64.2857142857143
"253","51","1",15,9,10,7,10,13,12,8,10,8,12,13,8,12,8,3,87,74,161,18,25,11.1801242236025,15.527950310559,45.9627329192547,54.0372670807453
"254","51","2",12,15,15,10,14,4,8,8,15,10,3,6,12,5,9,8,88,69,157,20,7,12.7388535031847,4.45859872611465,43.9490445859873,56.0509554140127
"255","51","3",7,9,6,11,7,3,5,8,9,7,4,3,9,4,8,9,57,55,112,16,7,14.2857142857143,6.25,49.1071428571429,50.8928571428571
"256","51","4",1,3,8,5,6,12,6,6,3,10,11,7,7,6,7,9,49,61,110,10,23,9.09090909090909,20.9090909090909,55.4545454545455,44.5454545454545
"257","51","5",19,6,7,2,9,17,3,0,7,3,19,1,1,2,0,0,66,33,99,19,36,19.1919191919192,36.3636363636364,33.3333333333333,66.6666666666667
"258","51","6",11,6,7,0,7,23,0,0,6,1,24,0,0,0,0,0,56,32,88,11,47,12.5,53.4090909090909,36.3636363636364,63.6363636363636
"259","52","1",0,1,1,2,2,3,1,7,0,2,4,6,0,7,7,20,18,48,66,20,7,30.3030303030303,10.6060606060606,72.7272727272727,27.2727272727273
"260","52","2",1,4,5,1,5,13,3,6,4,3,13,7,2,7,6,6,40,49,89,7,26,7.86516853932584,29.2134831460674,55.0561797752809,44.9438202247191
"261","52","3",0,0,3,5,5,11,6,6,0,8,13,7,3,8,5,3,36,50,86,3,24,3.48837209302326,27.906976744186,58.1395348837209,41.8604651162791
"262","52","4",2,2,2,3,2,10,4,5,2,3,10,6,3,7,5,12,31,50,81,14,20,17.2839506172839,24.6913580246914,61.7283950617284,38.2716049382716
"263","52","5",5,3,0,5,3,1,2,4,3,2,4,1,3,4,5,3,25,26,51,8,5,15.6862745098039,9.80392156862745,50.9803921568627,49.0196078431373
"264","52","6",4,5,3,4,3,2,5,1,4,2,2,2,4,2,1,0,29,18,47,4,4,8.51063829787234,8.51063829787234,38.2978723404255,61.7021276595745
"265","53","1",1,3,5,3,6,4,3,3,3,5,5,3,3,4,3,5,30,32,62,6,9,9.67741935483871,14.5161290322581,51.6129032258064,48.3870967741936
"266","53","2",3,4,8,4,8,18,8,4,4,8,18,8,4,8,4,5,58,61,119,8,36,6.72268907563025,30.2521008403361,51.2605042016807,48.7394957983193
"267","53","3",8,8,12,5,15,15,7,1,8,9,18,3,2,6,1,0,73,48,121,8,33,6.61157024793388,27.2727272727273,39.6694214876033,60.3305785123967
"268","53","4",21,8,8,5,8,5,6,3,8,5,4,4,5,3,3,1,65,35,100,22,9,22,9,35,65
"269","53","5",18,9,8,4,7,3,2,3,9,3,2,2,5,1,3,2,55,29,84,20,5,23.8095238095238,5.95238095238095,34.5238095238095,65.4761904761905
"270","53","6",26,5,3,4,5,2,3,3,5,3,3,2,3,3,3,0,53,23,76,26,5,34.2105263157895,6.57894736842105,30.2631578947368,69.7368421052632
"271","54","1",5,8,9,6,9,19,9,3,8,6,19,6,5,6,3,3,69,58,127,8,38,6.2992125984252,29.9212598425197,45.6692913385827,54.3307086614173
"272","54","2",0,2,5,9,7,12,13,9,2,12,15,13,7,15,9,9,59,83,142,9,27,6.33802816901408,19.0140845070423,58.4507042253521,41.5492957746479
"273","54","3",2,2,1,4,2,6,4,7,2,3,7,7,3,8,7,29,29,68,97,31,13,31.9587628865979,13.4020618556701,70.1030927835052,29.8969072164948
"274","54","4",1,4,4,3,4,2,2,2,4,3,2,1,3,1,2,7,24,24,48,8,4,16.6666666666667,8.33333333333333,50,50
"275","54","5",0,1,0,1,1,7,0,3,1,0,7,2,0,2,3,2,14,19,33,2,14,6.06060606060606,42.4242424242424,57.5757575757576,42.4242424242424
"276","54","6",4,1,0,2,1,0,0,2,0,2,1,0,1,1,2,0,12,8,20,4,1,20,5,40,60
"277","55","1",5,8,13,7,10,11,10,4,8,12,9,7,10,5,4,2,70,58,128,7,20,5.46875,15.625,45.3125,54.6875
"278","55","2",6,3,5,2,4,43,5,0,3,4,43,3,3,2,0,0,70,59,129,6,86,4.65116279069767,66.6666666666667,45.7364341085271,54.2635658914729
"279","55","3",3,6,9,9,9,9,8,6,6,12,8,5,9,4,6,9,60,61,121,12,17,9.91735537190083,14.0495867768595,50.4132231404959,49.5867768595041
"280","55","4",1,4,4,6,4,6,5,9,4,6,5,8,6,7,8,3,39,50,89,4,11,4.49438202247191,12.3595505617978,56.1797752808989,43.8202247191011
"281","55","5",5,4,5,1,4,6,1,2,4,2,5,2,2,2,3,2,29,24,53,7,11,13.2075471698113,20.7547169811321,45.2830188679245,54.7169811320755
"282","55","6",0,2,3,3,2,4,4,0,1,4,3,1,3,1,0,0,19,15,34,0,7,0,20.5882352941176,44.1176470588235,55.8823529411765
"283","58","1",2,5,9,3,8,24,9,14,5,7,23,20,4,18,13,24,74,117,191,26,47,13.6125654450262,24.6073298429319,61.2565445026178,38.7434554973822
"284","58","2",3,9,9,14,5,13,15,17,9,14,9,18,18,13,17,10,86,110,196,13,22,6.63265306122449,11.2244897959184,56.1224489795918,43.8775510204082
"285","58","3",5,3,3,8,4,14,13,15,3,8,15,21,7,21,15,24,66,116,182,29,29,15.9340659340659,15.9340659340659,63.7362637362637,36.2637362637363
"286","58","4",0,2,8,10,10,11,7,9,2,15,13,7,7,9,9,17,58,81,139,17,24,12.2302158273381,17.2661870503597,58.273381294964,41.726618705036
"287","58","5",9,10,12,5,11,15,7,4,10,6,15,6,5,6,4,6,75,59,134,15,30,11.1940298507463,22.3880597014925,44.0298507462687,55.9701492537313
"288","58","6",4,3,6,4,7,6,8,5,3,7,8,9,3,11,6,3,45,51,96,7,14,7.29166666666667,14.5833333333333,53.125,46.875
"289","59","1",7,11,9,11,10,12,15,4,11,9,14,7,10,9,4,3,81,68,149,10,26,6.71140939597315,17.4496644295302,45.6375838926174,54.3624161073826
"290","59","2",11,8,7,9,7,11,9,11,8,8,11,11,10,10,11,6,75,76,151,17,22,11.2582781456954,14.5695364238411,50.3311258278146,49.6688741721854
"291","59","3",10,6,10,7,8,20,13,5,6,11,18,11,9,9,5,2,80,73,153,12,38,7.84313725490196,24.8366013071895,47.7124183006536,52.2875816993464
"292","59","4",4,7,13,5,10,16,7,6,7,11,12,8,9,4,6,8,70,66,136,12,28,8.82352941176471,20.5882352941176,48.5294117647059,51.4705882352941
"293","59","5",5,6,10,4,8,29,5,8,6,8,27,8,6,6,7,5,75,76,151,10,56,6.62251655629139,37.0860927152318,50.3311258278146,49.6688741721854
"294","59","6",0,2,4,7,7,31,10,11,2,9,34,14,4,17,10,12,72,105,177,12,65,6.77966101694915,36.7231638418079,59.3220338983051,40.6779661016949
"295","6","1",3,3,7,2,5,10,5,3,3,6,8,6,3,5,3,3,39,39,78,6,18,7.69230769230769,23.0769230769231,50,50
"296","6","2",11,8,11,10,8,10,10,6,8,13,7,6,13,4,6,3,75,62,137,14,17,10.2189781021898,12.4087591240876,45.2554744525547,54.7445255474453
"297","6","3",9,4,4,4,2,27,11,3,4,4,25,10,6,7,3,5,65,66,131,14,52,10.6870229007634,39.6946564885496,50.381679389313,49.618320610687
"298","6","4",14,12,12,7,9,15,10,9,12,7,12,11,11,8,9,8,90,79,169,22,27,13.0177514792899,15.9763313609467,46.7455621301775,53.2544378698225
"299","6","5",10,5,10,6,9,22,8,2,5,10,21,4,6,3,2,0,73,53,126,10,43,7.93650793650794,34.1269841269841,42.0634920634921,57.9365079365079
"300","6","6",60,16,13,10,14,10,6,5,17,7,11,1,10,1,5,1,137,53,190,61,21,32.1052631578947,11.0526315789474,27.8947368421053,72.1052631578947
"301","60","1",2,4,3,7,1,16,8,18,3,6,14,19,9,17,18,35,61,122,183,37,30,20.2185792349727,16.3934426229508,66.6666666666667,33.3333333333333
"302","60","2",3,4,1,8,3,3,4,18,4,5,6,13,6,16,18,42,46,111,157,45,9,28.6624203821656,5.73248407643312,70.7006369426752,29.2993630573248
"303","60","3",5,8,4,5,2,15,4,12,8,1,13,11,8,8,12,11,57,73,130,16,28,12.3076923076923,21.5384615384615,56.1538461538462,43.8461538461538
"304","60","4",1,3,2,10,3,6,9,12,3,9,7,10,9,12,12,21,47,85,132,22,13,16.6666666666667,9.84848484848485,64.3939393939394,35.6060606060606
"305","60","5",0,2,3,3,2,10,2,8,2,4,9,8,4,7,9,22,31,67,98,22,19,22.4489795918367,19.3877551020408,68.3673469387755,31.6326530612245
"306","60","6",4,5,6,6,3,11,9,7,5,7,8,11,9,8,8,4,52,62,114,8,19,7.01754385964912,16.6666666666667,54.3859649122807,45.6140350877193
"307","62","1",1,1,2,0,1,9,1,0,1,1,8,1,1,0,0,0,17,13,30,1,17,3.33333333333333,56.6666666666667,43.3333333333333,56.6666666666667
"308","62","2",2,2,4,5,7,23,6,5,2,7,27,6,2,9,5,6,56,65,121,8,50,6.61157024793388,41.3223140495868,53.7190082644628,46.2809917355372
"309","62","3",0,0,0,6,4,26,4,6,0,6,31,4,2,8,6,14,48,72,120,14,57,11.6666666666667,47.5,60,40
"310","62","4",0,0,0,0,0,28,0,1,0,0,28,1,0,1,1,1,30,34,64,1,56,1.5625,87.5,53.125,46.875
"311","62","5",0,0,0,0,0,14,0,0,0,0,14,0,0,0,0,0,16,15,31,0,28,0,90.3225806451613,48.3870967741936,51.6129032258064
"312","62","6",0,0,0,0,0,11,0,0,0,0,11,0,0,0,0,0,12,13,25,0,22,0,88,52,48
"313","63","1",2,1,4,0,3,6,1,1,2,2,5,2,1,1,1,0,21,14,35,2,11,5.71428571428571,31.4285714285714,40,60
"314","63","2",15,7,7,3,5,11,5,0,7,3,9,2,5,1,0,0,54,29,83,15,20,18.0722891566265,24.0963855421687,34.9397590361446,65.0602409638554
"315","63","3",13,9,11,2,9,5,3,2,9,4,3,3,4,1,2,0,57,26,83,13,8,15.6626506024096,9.63855421686747,31.3253012048193,68.6746987951807
"316","63","4",23,7,6,2,5,6,5,0,7,1,5,3,3,2,0,0,55,23,78,23,11,29.4871794871795,14.1025641025641,29.4871794871795,70.5128205128205
"317","63","5",4,5,4,7,7,3,9,0,5,6,6,1,5,4,0,0,41,28,69,4,9,5.79710144927536,13.0434782608696,40.5797101449275,59.4202898550725
"318","63","6",11,8,7,3,5,3,3,2,9,1,1,2,5,0,2,2,45,22,67,13,4,19.4029850746269,5.97014925373134,32.8358208955224,67.1641791044776
"319","64","1",22,13,13,9,11,10,11,7,13,9,8,9,10,7,7,4,97,69,166,26,18,15.6626506024096,10.8433734939759,41.566265060241,58.433734939759
"320","64","2",4,5,8,3,8,46,4,2,5,6,46,3,3,3,2,0,82,69,151,4,92,2.64900662251656,60.9271523178808,45.6953642384106,54.3046357615894
"321","64","3",1,1,2,0,2,94,2,0,1,1,95,2,0,2,0,0,104,102,206,1,189,0.485436893203884,91.747572815534,49.5145631067961,50.4854368932039
"322","64","4",0,0,0,0,0,76,2,0,0,0,76,2,0,2,0,0,79,82,161,0,152,0,94.4099378881988,50.9316770186335,49.0683229813665
"323","64","5",0,0,1,0,1,77,1,0,0,1,76,1,0,1,0,0,81,81,162,0,153,0,94.4444444444444,50,50
"324","64","6",3,3,3,2,4,60,4,1,3,2,60,3,1,4,1,0,81,76,157,3,120,1.91082802547771,76.4331210191083,48.4076433121019,51.5923566878981
"325","65","1",1,1,6,3,5,17,3,10,1,8,17,9,4,9,10,21,48,80,128,22,34,17.1875,26.5625,62.5,37.5
"326","65","2",1,4,10,7,13,19,13,1,4,13,21,7,4,10,1,1,69,63,132,2,40,1.51515151515152,30.3030303030303,47.7272727272727,52.2727272727273
"327","65","3",0,0,5,2,8,22,8,1,0,8,25,7,0,9,1,0,48,51,99,0,47,0,47.4747474747475,51.5151515151515,48.4848484848485
"328","65","4",0,0,0,7,2,12,0,20,0,7,14,14,5,15,20,36,42,113,155,36,26,23.2258064516129,16.7741935483871,72.9032258064516,27.0967741935484
"329","65","5",0,0,2,3,2,16,5,3,0,5,16,5,4,5,4,23,33,63,96,23,32,23.9583333333333,33.3333333333333,65.625,34.375
"330","65","6",1,0,2,2,2,17,7,6,1,4,17,11,3,11,6,3,40,56,96,4,34,4.16666666666667,35.4166666666667,58.3333333333333,41.6666666666667
"331","68","1",4,6,8,7,5,23,12,7,6,8,20,12,9,9,7,5,73,78,151,9,43,5.96026490066225,28.476821192053,51.6556291390729,48.3443708609271
"332","68","2",4,4,7,6,6,13,11,5,4,10,12,10,8,9,6,4,58,64,122,8,25,6.55737704918033,20.4918032786885,52.4590163934426,47.5409836065574
"333","68","3",11,8,4,7,3,5,10,6,8,3,4,10,8,8,6,2,55,51,106,13,9,12.2641509433962,8.49056603773585,48.1132075471698,51.8867924528302
"334","68","4",3,6,3,6,4,6,3,10,6,3,7,7,6,8,10,7,43,55,98,10,13,10.2040816326531,13.265306122449,56.1224489795918,43.8775510204082
"335","68","5",1,3,2,6,4,5,6,3,3,4,7,3,3,5,3,8,31,38,69,9,12,13.0434782608696,17.3913043478261,55.0724637681159,44.9275362318841
"336","68","6",0,0,1,2,0,3,3,8,0,3,3,9,3,9,9,14,19,51,70,14,6,20,8.57142857142857,72.8571428571429,27.1428571428571
"337","69","1",3,3,3,7,4,20,9,5,3,7,21,7,5,9,5,7,55,66,121,10,41,8.26446280991735,33.8842975206612,54.5454545454545,45.4545454545455
"338","69","2",4,4,6,5,6,20,4,5,4,7,21,4,5,4,5,8,56,59,115,12,41,10.4347826086957,35.6521739130435,51.304347826087,48.695652173913
"339","69","3",4,1,5,1,2,18,4,7,1,5,16,10,4,8,8,5,44,58,102,9,34,8.82352941176471,33.3333333333333,56.8627450980392,43.1372549019608
"340","69","4",1,1,6,2,6,9,4,8,1,7,10,10,2,10,8,17,39,66,105,18,19,17.1428571428571,18.0952380952381,62.8571428571429,37.1428571428571
"341","69","5",0,2,4,4,5,10,5,7,2,7,11,8,4,9,7,12,39,61,100,12,21,12,21,61,39
"342","69","6",0,0,3,4,1,7,8,9,0,7,5,13,6,10,9,17,33,69,102,17,12,16.6666666666667,11.7647058823529,67.6470588235294,32.3529411764706
"343","7","1",12,11,11,10,12,18,11,12,11,10,20,13,9,15,12,5,99,96,195,17,38,8.71794871794872,19.4871794871795,49.2307692307692,50.7692307692308
"344","7","2",8,12,9,12,10,10,11,17,12,10,10,16,12,16,17,21,91,115,206,29,20,14.0776699029126,9.70873786407767,55.8252427184466,44.1747572815534
"345","7","3",13,9,13,6,10,16,7,13,9,10,13,14,9,11,12,9,87,90,177,22,29,12.4293785310734,16.3841807909605,50.8474576271186,49.1525423728814
"346","7","4",9,6,9,6,7,23,10,5,7,9,21,9,9,7,5,3,78,70,148,12,44,8.10810810810811,29.7297297297297,47.2972972972973,52.7027027027027
"347","7","5",3,4,8,3,6,16,5,8,4,7,14,11,4,9,8,8,54,67,121,11,30,9.09090909090909,24.7933884297521,55.3719008264463,44.6280991735537
"348","7","6",0,0,0,4,3,8,5,8,0,4,12,9,1,13,9,15,30,64,94,15,20,15.9574468085106,21.2765957446809,68.0851063829787,31.9148936170213
"349","70","1",0,3,8,3,3,14,7,11,3,8,9,15,8,10,11,11,51,76,127,11,23,8.66141732283465,18.1102362204724,59.8425196850394,40.1574803149606
"350","70","2",1,3,4,4,4,15,7,6,3,5,16,8,4,9,6,14,46,66,112,15,31,13.3928571428571,27.6785714285714,58.9285714285714,41.0714285714286
"351","70","3",0,2,6,2,4,14,7,3,2,6,12,8,4,5,2,3,38,45,83,3,26,3.6144578313253,31.3253012048193,54.2168674698795,45.7831325301205
"352","70","4",0,1,3,1,1,15,5,3,1,3,14,7,3,6,3,0,31,38,69,0,29,0,42.0289855072464,55.0724637681159,44.9275362318841
"353","70","5",0,0,1,4,4,15,5,2,0,6,17,3,2,5,2,3,33,39,72,3,32,4.16666666666667,44.4444444444444,54.1666666666667,45.8333333333333
"354","70","6",0,0,1,6,2,12,4,7,0,7,13,5,5,6,7,14,33,59,92,14,25,15.2173913043478,27.1739130434783,64.1304347826087,35.8695652173913
"355","71","1",2,3,5,10,8,14,10,9,3,12,16,9,7,11,9,10,62,79,141,12,30,8.51063829787234,21.2765957446809,56.0283687943262,43.9716312056738
"356","71","2",4,3,5,6,9,17,7,8,4,8,21,9,3,13,8,12,62,78,140,16,38,11.4285714285714,27.1428571428571,55.7142857142857,44.2857142857143
"357","71","3",1,4,8,8,9,8,7,14,4,12,9,13,8,14,15,10,61,86,147,11,17,7.48299319727891,11.5646258503401,58.5034013605442,41.4965986394558
"358","71","4",2,5,6,4,4,13,5,7,6,5,10,8,7,5,7,12,49,60,109,14,23,12.8440366972477,21.1009174311927,55.045871559633,44.954128440367
"359","71","5",3,4,5,7,2,8,7,6,4,8,5,6,9,3,5,5,42,48,90,8,13,8.88888888888889,14.4444444444444,53.3333333333333,46.6666666666667
"360","71","6",11,7,12,5,10,5,7,2,7,11,3,4,7,2,2,3,61,40,101,14,8,13.8613861386139,7.92079207920792,39.6039603960396,60.3960396039604
"361","78","1",2,3,8,5,6,35,15,9,3,10,33,19,7,17,10,13,84,114,198,15,68,7.57575757575758,34.3434343434343,57.5757575757576,42.4242424242424
"362","78","2",0,0,1,3,0,5,6,12,0,4,4,15,4,14,12,71,27,127,154,71,9,46.1038961038961,5.84415584415584,82.4675324675325,17.5324675324675
"363","78","3",0,0,1,1,1,6,4,14,0,2,6,17,1,17,14,22,28,81,109,22,12,20.1834862385321,11.0091743119266,74.3119266055046,25.6880733944954
"364","78","4",0,1,0,6,1,0,8,8,1,5,1,11,5,12,9,25,25,71,96,25,1,26.0416666666667,1.04166666666667,73.9583333333333,26.0416666666667
"365","78","5",9,4,1,8,2,3,9,2,4,5,4,3,8,4,3,4,40,36,76,13,7,17.1052631578947,9.21052631578947,47.3684210526316,52.6315789473684
"366","78","6",5,3,3,3,2,4,3,7,3,3,3,6,4,5,6,12,30,45,75,17,7,22.6666666666667,9.33333333333333,60,40
"367","79","1",4,4,7,6,7,18,13,4,4,9,17,11,6,11,4,4,64,68,132,8,35,6.06060606060606,26.5151515151515,51.5151515151515,48.4848484848485
"368","79","2",9,5,12,7,10,17,10,6,5,13,15,9,9,7,6,2,78,67,145,11,32,7.58620689655172,22.0689655172414,46.2068965517241,53.7931034482759
"369","79","3",4,4,10,5,11,10,8,5,4,11,12,8,4,10,5,7,59,62,121,11,22,9.09090909090909,18.1818181818182,51.2396694214876,48.7603305785124
"370","79","4",1,3,6,6,5,14,8,6,3,9,13,7,7,6,6,10,50,63,113,11,27,9.73451327433628,23.8938053097345,55.7522123893805,44.2477876106195
"371","79","5",9,4,2,7,5,7,2,10,4,5,10,5,4,8,10,5,47,53,100,14,17,14,17,53,47
"372","79","6",10,4,7,1,9,5,2,3,5,4,7,3,0,5,3,2,44,29,73,12,12,16.4383561643836,16.4383561643836,39.7260273972603,60.2739726027397
"373","8","1",4,8,15,7,14,19,9,9,8,14,17,11,8,9,9,16,86,94,180,20,36,11.1111111111111,20,52.2222222222222,47.7777777777778
"374","8","2",11,10,10,13,11,18,15,7,10,12,19,10,11,11,7,2,96,84,180,13,37,7.22222222222222,20.5555555555556,46.6666666666667,53.3333333333333
"375","8","3",5,9,13,12,12,13,12,8,9,16,12,7,14,6,8,7,86,80,166,12,25,7.2289156626506,15.0602409638554,48.1927710843374,51.8072289156626
"376","8","4",11,8,7,10,9,13,6,10,8,9,15,5,9,7,10,15,76,79,155,26,28,16.7741935483871,18.0645161290323,50.9677419354839,49.0322580645161
"377","8","5",2,2,10,4,10,20,8,8,2,11,20,12,3,13,8,8,65,79,144,10,40,6.94444444444444,27.7777777777778,54.8611111111111,45.1388888888889
"378","8","6",2,8,10,9,5,12,8,10,8,11,7,9,14,4,9,17,64,82,146,19,19,13.013698630137,13.013698630137,56.1643835616438,43.8356164383562
"379","80","1",13,9,8,11,8,8,7,7,9,10,8,3,11,4,7,7,72,61,133,20,16,15.0375939849624,12.0300751879699,45.8646616541353,54.1353383458647
"380","80","2",2,6,6,7,6,22,8,6,5,7,22,7,6,8,6,1,64,64,128,3,44,2.34375,34.375,50,50
"381","80","3",3,5,6,8,7,10,10,4,5,9,11,6,7,7,4,1,55,51,106,4,21,3.77358490566038,19.811320754717,48.1132075471698,51.8867924528302
"382","80","4",3,4,5,4,6,6,6,6,4,5,7,8,4,9,6,3,42,47,89,6,13,6.74157303370786,14.6067415730337,52.8089887640449,47.1910112359551
"383","80","5",0,2,5,8,5,8,11,5,2,10,8,8,7,8,5,4,45,54,99,4,16,4.04040404040404,16.1616161616162,54.5454545454545,45.4545454545455
"384","80","6",0,2,4,5,5,11,7,2,2,7,12,4,4,5,2,1,38,38,76,1,23,1.31578947368421,30.2631578947368,50,50
"385","81","1",1,3,7,4,6,16,6,10,3,8,15,12,4,11,10,15,54,80,134,16,31,11.9402985074627,23.134328358209,59.7014925373134,40.2985074626866
"386","81","2",5,7,6,10,7,10,10,9,7,9,11,9,9,10,9,10,65,76,141,15,21,10.6382978723404,14.8936170212766,53.9007092198582,46.0992907801418
"387","81","3",5,9,8,7,9,14,4,7,9,6,15,3,6,5,7,9,64,62,126,14,29,11.1111111111111,23.015873015873,49.2063492063492,50.7936507936508
"388","81","4",21,8,6,6,7,13,6,3,8,4,15,2,5,4,3,0,72,42,114,21,28,18.4210526315789,24.5614035087719,36.8421052631579,63.1578947368421
"389","81","5",1,2,3,3,0,17,4,7,2,4,14,7,6,4,6,20,37,66,103,21,31,20.3883495145631,30.0970873786408,64.0776699029126,35.9223300970874
"390","81","6",0,2,7,2,5,7,3,4,2,7,5,5,5,3,4,6,32,38,70,6,12,8.57142857142857,17.1428571428571,54.2857142857143,45.7142857142857
"391","82","1",1,2,4,1,4,6,0,1,2,3,7,0,0,1,1,0,21,15,36,1,13,2.77777777777778,36.1111111111111,41.6666666666667,58.3333333333333
"392","82","2",0,0,0,2,0,0,0,2,0,2,0,0,2,0,2,0,5,8,13,0,0,0,0,61.5384615384615,38.4615384615385
"393","82","3",1,1,0,1,1,0,1,0,1,0,1,0,1,1,0,0,7,5,12,1,1,8.33333333333333,8.33333333333333,41.6666666666667,58.3333333333333
"394","82","4",0,0,0,0,0,0,0,0,0,0,0,0,0,0,0,0,0,0,0,0,0,NA,NA,NA,NA
"395","82","5",0,0,0,0,0,0,0,0,0,0,0,0,0,0,0,0,0,0,0,0,0,NA,NA,NA,NA
"396","82","6",0,0,0,0,0,0,0,0,0,0,0,0,0,0,0,0,0,0,0,0,0,NA,NA,NA,NA
"397","83","1",0,0,0,0,0,4,2,1,0,0,4,3,1,3,1,0,9,13,22,0,8,0,36.3636363636364,59.0909090909091,40.9090909090909
"398","83","2",4,1,1,1,1,5,1,1,1,1,5,1,1,1,1,1,17,13,30,5,10,16.6666666666667,33.3333333333333,43.3333333333333,56.6666666666667
"399","83","3",2,1,4,6,4,16,7,2,1,9,15,3,6,3,2,3,43,44,87,5,31,5.74712643678161,35.632183908046,50.5747126436782,49.4252873563218
"400","83","4",3,4,7,1,8,19,4,2,4,4,20,5,0,6,2,3,50,45,95,6,39,6.31578947368421,41.0526315789474,47.3684210526316,52.6315789473684
"401","83","5",3,2,2,6,4,20,4,5,2,6,22,3,3,5,5,5,47,53,100,8,42,8,42,53,47
"402","83","6",0,1,3,3,4,23,4,3,1,5,25,4,1,6,3,9,43,55,98,9,48,9.18367346938776,48.9795918367347,56.1224489795918,43.8775510204082
"403","84","1",9,8,6,8,8,18,8,11,7,7,20,11,6,13,11,13,78,89,167,22,38,13.1736526946108,22.7544910179641,53.2934131736527,46.7065868263473
"404","84","2",9,5,7,7,9,15,7,9,5,10,17,9,6,11,10,13,70,82,152,22,32,14.4736842105263,21.0526315789474,53.9473684210526,46.0526315789474
"405","84","3",2,5,3,5,3,11,6,8,6,3,11,9,6,9,8,6,46,58,104,8,22,7.69230769230769,21.1538461538462,55.7692307692308,44.2307692307692
"406","84","4",3,5,6,6,7,5,5,7,5,6,7,6,4,8,7,8,46,52,98,11,12,11.2244897959184,12.2448979591837,53.0612244897959,46.9387755102041
"407","84","5",3,1,6,4,7,10,3,7,1,9,11,6,4,7,7,8,43,54,97,11,21,11.340206185567,21.6494845360825,55.6701030927835,44.3298969072165
"408","84","6",2,3,3,6,3,5,4,5,3,7,5,3,7,3,6,19,33,54,87,21,10,24.1379310344828,11.4942528735632,62.0689655172414,37.9310344827586
"409","85","1",5,8,7,8,6,10,11,4,8,6,9,7,9,6,4,4,61,54,115,9,19,7.82608695652174,16.5217391304348,46.9565217391304,53.0434782608696
"410","85","2",4,6,5,7,6,10,10,4,6,6,11,6,6,8,4,4,53,53,106,8,21,7.54716981132075,19.811320754717,50,50
"411","85","3",0,1,9,1,6,13,5,0,1,8,10,4,3,2,0,0,36,30,66,0,23,0,34.8484848484849,45.4545454545455,54.5454545454545
"412","85","4",0,0,3,0,2,8,2,0,0,3,6,2,1,1,0,0,16,15,31,0,14,0,45.1612903225806,48.3870967741936,51.6129032258064
"413","85","5",1,2,3,0,3,19,2,0,2,1,18,2,0,1,0,0,31,26,57,1,37,1.75438596491228,64.9122807017544,45.6140350877193,54.3859649122807
"414","85","6",0,0,0,0,0,25,1,0,0,0,24,1,0,1,0,0,27,28,55,0,49,0,89.0909090909091,50.9090909090909,49.0909090909091
"415","86","1",2,4,5,5,7,10,11,8,4,6,12,14,3,16,8,5,53,70,123,7,22,5.69105691056911,17.8861788617886,56.9105691056911,43.0894308943089
"416","86","2",2,5,8,8,6,6,10,9,5,11,4,11,9,9,8,12,54,72,126,14,10,11.1111111111111,7.93650793650794,57.1428571428571,42.8571428571429
"417","86","3",1,3,5,4,7,13,9,4,3,6,15,9,3,11,4,2,48,54,102,3,28,2.94117647058824,27.4509803921569,52.9411764705882,47.0588235294118
"418","86","4",2,3,8,4,6,18,6,6,3,9,17,8,6,7,6,5,55,62,117,7,35,5.98290598290598,29.9145299145299,52.991452991453,47.008547008547
"419","86","5",4,1,2,3,1,16,5,3,1,4,15,5,3,4,2,2,35,39,74,6,31,8.10810810810811,41.8918918918919,52.7027027027027,47.2972972972973
"420","86","6",0,0,1,0,0,7,1,5,0,1,5,6,1,4,5,15,15,39,54,15,12,27.7777777777778,22.2222222222222,72.2222222222222,27.7777777777778
"421","87","1",2,3,3,7,4,2,7,9,3,7,3,9,6,10,9,10,39,58,97,12,5,12.3711340206186,5.15463917525773,59.7938144329897,40.2061855670103
"422","87","2",1,3,4,3,5,14,5,8,3,5,15,9,3,10,8,21,45,75,120,22,29,18.3333333333333,24.1666666666667,62.5,37.5
"423","87","3",12,2,5,5,3,9,2,13,2,8,6,10,7,7,12,12,51,67,118,24,15,20.3389830508475,12.7118644067797,56.7796610169492,43.2203389830508
"424","87","4",4,3,1,3,1,7,3,10,3,1,7,10,3,10,10,14,32,61,93,18,14,19.3548387096774,15.0537634408602,65.5913978494624,34.4086021505376
"425","87","5",0,0,1,0,0,9,3,4,0,1,7,7,2,5,4,6,19,33,52,6,16,11.5384615384615,30.7692307692308,63.4615384615385,36.5384615384615
"426","87","6",0,0,0,0,0,4,0,2,0,0,4,2,0,3,3,27,7,41,48,27,8,56.25,16.6666666666667,85.4166666666667,14.5833333333333
"427","9","1",8,12,11,11,9,12,16,14,12,10,10,19,12,17,13,27,93,123,216,35,22,16.2037037037037,10.1851851851852,56.9444444444444,43.0555555555556
"428","9","2",1,6,5,10,5,14,8,19,6,9,14,17,10,17,19,36,68,131,199,37,28,18.5929648241206,14.070351758794,65.8291457286432,34.1708542713568
"429","9","3",3,8,7,7,11,12,9,15,9,6,16,17,4,20,15,10,75,97,172,13,28,7.55813953488372,16.2790697674419,56.3953488372093,43.6046511627907
"430","9","4",4,6,11,9,9,9,12,6,6,14,8,9,11,8,6,9,68,72,140,13,17,9.28571428571429,12.1428571428571,51.4285714285714,48.5714285714286
"431","9","5",3,1,2,5,5,9,3,10,1,6,12,8,2,11,10,24,38,77,115,27,21,23.4782608695652,18.2608695652174,66.9565217391304,33.0434782608696
"432","9","6",0,0,0,0,0,1,3,6,0,0,2,9,0,10,7,25,12,54,66,25,3,37.8787878787879,4.54545454545455,81.8181818181818,18.1818181818182
"433","92","1",1,2,5,0,5,5,0,0,3,2,5,0,0,0,0,0,21,10,31,1,10,3.2258064516129,32.258064516129,32.258064516129,67.741935483871
"434","92","2",0,0,0,0,0,0,1,0,0,0,0,1,1,0,0,0,3,3,6,0,0,0,0,50,50
"435","92","3",0,0,1,0,0,3,2,1,0,1,1,4,1,2,1,0,8,12,20,0,4,0,20,60,40
"436","92","4",1,2,2,1,3,0,0,1,2,1,0,0,0,0,0,0,10,6,16,1,0,6.25,0,37.5,62.5
"437","92","5",0,2,2,0,1,1,1,1,2,0,0,2,0,1,1,1,9,9,18,1,1,5.55555555555556,5.55555555555556,50,50
"438","92","6",0,1,1,0,1,4,2,1,1,1,3,3,1,2,1,0,12,13,25,0,7,0,28,52,48
"439","97","1",2,3,12,2,11,18,4,12,3,12,17,14,4,13,13,24,66,101,167,26,35,15.5688622754491,20.9580838323353,60.4790419161677,39.5209580838323
"440","97","2",2,7,12,5,11,17,6,7,6,10,16,8,5,8,7,13,68,75,143,15,33,10.4895104895105,23.0769230769231,52.4475524475524,47.5524475524476
"441","97","3",2,1,2,5,5,49,7,2,1,6,52,4,1,8,2,1,74,77,151,3,101,1.98675496688742,66.887417218543,50.9933774834437,49.0066225165563
"442","97","4",0,1,3,4,6,45,4,3,1,6,48,3,1,6,3,4,68,73,141,4,93,2.83687943262411,65.9574468085106,51.7730496453901,48.2269503546099
"443","97","5",1,1,2,2,3,44,3,1,1,3,46,2,1,3,1,1,59,59,118,2,90,1.69491525423729,76.271186440678,50,50
"444","97","6",0,0,0,3,3,23,3,0,0,3,26,0,0,3,0,0,33,34,67,0,49,0,73.134328358209,50.7462686567164,49.2537313432836
"445","98","1",21,13,16,4,12,17,7,3,13,7,12,6,9,1,3,5,95,57,152,26,29,17.1052631578947,19.0789473684211,37.5,62.5
"446","98","2",15,14,14,11,14,18,11,6,14,11,18,6,11,5,6,8,104,81,185,23,36,12.4324324324324,19.4594594594595,43.7837837837838,56.2162162162162
"447","98","3",0,3,12,8,14,15,8,8,3,17,16,8,7,9,8,4,70,73,143,4,31,2.7972027972028,21.6783216783217,51.048951048951,48.951048951049
"448","98","4",4,3,17,2,15,40,4,2,3,16,37,4,4,2,2,0,88,70,158,4,77,2.53164556962025,48.7341772151899,44.3037974683544,55.6962025316456
"449","98","5",2,1,11,2,10,28,2,2,1,12,26,3,3,1,2,0,59,50,109,2,54,1.8348623853211,49.5412844036697,45.8715596330275,54.1284403669725
"450","98","6",6,7,14,5,15,26,6,3,6,12,27,4,3,6,3,0,83,63,146,6,53,4.10958904109589,36.3013698630137,43.1506849315069,56.8493150684931
"451","99","1",9,10,9,8,11,7,10,1,9,7,9,3,6,5,1,0,67,41,108,9,16,8.33333333333333,14.8148148148148,37.962962962963,62.037037037037
"452","99","2",16,10,14,6,16,14,8,3,10,10,17,5,4,8,3,7,89,65,154,23,31,14.9350649350649,20.1298701298701,42.2077922077922,57.7922077922078
"453","99","3",8,6,10,4,10,16,9,4,6,8,15,9,5,8,4,2,69,58,127,10,31,7.8740157480315,24.4094488188976,45.6692913385827,54.3307086614173
"454","99","4",15,13,16,5,18,18,5,3,14,7,20,3,3,5,3,3,96,58,154,18,38,11.6883116883117,24.6753246753247,37.6623376623377,62.3376623376623
"455","99","5",13,7,10,5,9,6,5,3,7,7,5,4,5,3,3,2,59,38,97,15,11,15.4639175257732,11.340206185567,39.1752577319588,60.8247422680412
"456","99","6",0,0,0,0,0,0,0,0,0,0,0,0,0,0,0,0,0,0,0,0,0,NA,NA,NA,NA
