"","fish_id","bin","LLLL","LLLR","LLRL","LLRR","LRLL","LRLR","LRRL","LRRR","RLLL","RLLR","RLRL","RLRR","RRLL","RRLR","RRRL","RRRR","L","R","total_turns","reps","alts","rel_reps","rel_alts","rel_R","rel_L"
"1","1","1",23,13,12,4,8,19,7,3,12,3,16,6,7,3,3,2,91,53,144,25,35,17.3611111111111,24.3055555555556,36.8055555555556,63.1944444444444
"2","1","2",14,8,6,6,7,4,5,1,7,4,5,0,4,1,1,2,52,26,78,16,9,20.5128205128205,11.5384615384615,33.3333333333333,66.6666666666667
"3","1","3",1,1,2,1,2,3,3,1,1,2,3,3,2,3,2,1,16,18,34,2,6,5.88235294117647,17.6470588235294,52.9411764705882,47.0588235294118
"4","1","4",1,2,2,0,2,3,0,0,2,0,4,0,0,1,0,0,12,8,20,1,7,5,35,40,60
"5","1","5",1,1,1,0,1,0,0,0,1,0,0,0,0,0,0,0,7,1,8,1,0,12.5,0,12.5,87.5
"6","1","6",0,0,0,0,0,0,0,0,0,0,0,0,0,0,0,0,2,0,2,0,0,0,0,0,100
"7","10","1",14,9,10,10,12,14,11,2,9,11,16,3,7,6,2,1,83,57,140,15,30,10.7142857142857,21.4285714285714,40.7142857142857,59.2857142857143
"8","10","2",16,11,14,2,15,15,3,0,11,5,16,1,1,2,0,0,79,36,115,16,31,13.9130434782609,26.9565217391304,31.304347826087,68.695652173913
"9","10","3",22,9,9,2,5,17,6,2,9,3,13,5,7,1,2,0,74,41,115,22,30,19.1304347826087,26.0869565217391,35.6521739130435,64.3478260869565
"10","10","4",14,10,5,8,7,5,7,4,11,3,7,3,7,4,4,0,63,39,102,14,12,13.7254901960784,11.7647058823529,38.2352941176471,61.7647058823529
"11","10","5",14,8,5,4,7,4,3,2,8,1,7,0,2,3,2,0,49,24,73,14,11,19.1780821917808,15.0684931506849,32.8767123287671,67.1232876712329
"12","10","6",24,3,3,1,4,2,0,2,4,1,3,1,1,1,2,2,42,15,57,26,5,45.6140350877193,8.7719298245614,26.3157894736842,73.6842105263158
"13","11","1",7,10,11,14,20,17,12,8,10,15,26,6,5,15,8,5,100,92,192,12,43,6.25,22.3958333333333,47.9166666666667,52.0833333333333
"14","11","2",8,5,9,8,11,18,7,5,5,11,20,5,5,7,5,3,72,63,135,11,38,8.14814814814815,28.1481481481481,46.6666666666667,53.3333333333333
"15","11","3",8,9,12,4,10,8,5,3,9,7,5,4,6,1,3,1,60,38,98,9,13,9.18367346938776,13.265306122449,38.7755102040816,61.2244897959184
"16","11","4",6,4,5,3,5,14,6,3,4,4,13,6,3,5,3,4,47,44,91,10,27,10.989010989011,29.6703296703297,48.3516483516484,51.6483516483516
"17","11","5",6,7,13,1,11,13,2,2,8,7,10,3,4,0,2,0,58,34,92,6,23,6.52173913043478,25,36.9565217391304,63.0434782608696
"18","11","6",4,6,12,4,7,10,10,0,6,10,6,6,8,2,0,0,55,39,94,4,16,4.25531914893617,17.0212765957447,41.4893617021277,58.5106382978723
"19","12","1",11,11,14,10,11,42,16,14,11,13,40,19,13,17,14,17,131,145,276,28,82,10.1449275362319,29.7101449275362,52.536231884058,47.463768115942
"20","12","2",4,8,16,10,16,38,13,10,8,19,38,13,11,13,11,11,117,125,242,15,76,6.19834710743802,31.404958677686,51.6528925619835,48.3471074380165
"21","12","3",14,9,16,12,18,16,11,14,9,19,18,14,10,16,15,7,111,110,221,21,34,9.50226244343891,15.3846153846154,49.7737556561086,50.2262443438914
"22","12","4",10,13,12,9,14,12,8,8,13,8,15,7,6,10,8,5,88,73,161,15,27,9.3167701863354,16.7701863354037,45.3416149068323,54.6583850931677
"23","12","5",12,7,13,6,15,18,11,3,8,12,20,7,5,9,3,3,88,67,155,15,38,9.67741935483871,24.5161290322581,43.2258064516129,56.7741935483871
"24","12","6",4,4,5,9,7,11,7,6,4,10,13,3,7,5,6,7,54,57,111,11,24,9.90990990990991,21.6216216216216,51.3513513513514,48.6486486486486
"25","13","1",5,9,9,13,8,10,12,8,8,14,9,7,14,6,8,15,76,82,158,20,19,12.6582278481013,12.0253164556962,51.8987341772152,48.1012658227848
"26","13","2",5,6,10,6,10,13,8,6,6,10,13,8,5,9,6,2,65,61,126,7,26,5.55555555555556,20.6349206349206,48.4126984126984,51.5873015873016
"27","13","3",2,5,7,4,5,18,7,6,5,6,15,10,6,7,6,4,55,61,116,6,33,5.17241379310345,28.448275862069,52.5862068965517,47.4137931034483
"28","13","4",6,6,7,7,8,15,9,6,6,8,16,8,6,10,7,6,65,69,134,12,31,8.95522388059701,23.134328358209,51.4925373134328,48.5074626865672
"29","13","5",2,3,3,3,2,17,12,4,3,3,16,12,5,11,4,10,48,65,113,12,33,10.6194690265487,29.2035398230088,57.5221238938053,42.4778761061947
"30","13","6",0,1,0,2,0,4,0,8,1,1,4,6,2,5,7,15,15,44,59,15,8,25.4237288135593,13.5593220338983,74.5762711864407,25.4237288135593
"31","14","1",2,5,9,8,7,11,8,12,5,12,9,13,9,11,12,11,63,84,147,13,20,8.84353741496599,13.6054421768707,57.1428571428571,42.8571428571429
"32","14","2",10,15,9,10,12,18,10,5,15,4,21,5,7,8,4,2,89,69,158,12,39,7.59493670886076,24.6835443037975,43.6708860759494,56.3291139240506
"33","14","3",11,5,12,5,10,22,7,7,5,12,20,9,8,6,7,5,81,73,154,16,42,10.3896103896104,27.2727272727273,47.4025974025974,52.5974025974026
"34","14","4",21,11,14,7,15,16,12,2,11,10,17,6,6,8,2,1,99,63,162,22,33,13.5802469135802,20.3703703703704,38.8888888888889,61.1111111111111
"35","14","5",9,8,9,10,7,7,8,5,8,11,5,3,12,1,5,6,65,52,117,15,12,12.8205128205128,10.2564102564103,44.4444444444444,55.5555555555556
"36","14","6",10,8,8,7,7,10,10,4,8,7,9,8,8,7,5,4,65,58,123,14,19,11.3821138211382,15.4471544715447,47.1544715447154,52.8455284552846
"37","15","1",4,3,6,5,5,23,9,8,3,8,22,12,5,11,8,11,64,82,146,15,45,10.2739726027397,30.8219178082192,56.1643835616438,43.8356164383562
"38","15","2",2,3,5,2,6,21,9,2,3,4,23,9,1,10,2,3,52,56,108,5,44,4.62962962962963,40.7407407407407,51.8518518518519,48.1481481481481
"39","15","3",2,4,6,2,4,32,4,2,4,4,30,4,4,3,2,2,57,55,112,4,62,3.57142857142857,55.3571428571429,49.1071428571429,50.8928571428571
"40","15","4",1,1,3,3,3,10,6,6,1,5,9,9,3,9,6,15,34,59,93,16,19,17.2043010752688,20.4301075268817,63.4408602150538,36.5591397849462
"41","15","5",1,1,2,3,1,4,0,7,1,4,3,5,4,3,7,14,20,43,63,15,7,23.8095238095238,11.1111111111111,68.2539682539683,31.7460317460317
"42","15","6",0,0,0,1,0,5,1,7,0,1,4,7,1,6,7,7,15,35,50,7,9,14,18,70,30
"43","16","1",6,7,14,4,12,21,8,5,7,11,19,8,7,6,5,4,79,68,147,10,40,6.80272108843537,27.2108843537415,46.2585034013605,53.7414965986395
"44","16","2",15,11,14,6,11,21,10,7,11,9,18,11,10,7,7,8,97,82,179,23,39,12.8491620111732,21.7877094972067,45.8100558659218,54.1899441340782
"45","16","3",7,4,10,5,8,22,8,4,4,11,20,7,7,5,4,10,69,70,139,17,42,12.2302158273381,30.2158273381295,50.3597122302158,49.6402877697842
"46","16","4",1,1,5,2,3,18,7,5,1,6,17,10,4,9,5,5,44,58,102,6,35,5.88235294117647,34.3137254901961,56.8627450980392,43.1372549019608
"47","16","5",0,1,2,0,0,17,0,5,1,1,15,5,1,3,4,7,25,40,65,7,32,10.7692307692308,49.2307692307692,61.5384615384615,38.4615384615385
"48","16","6",0,0,0,0,0,6,0,4,0,0,7,4,0,4,4,4,12,24,36,4,13,11.1111111111111,36.1111111111111,66.6666666666667,33.3333333333333
"49","17","1",2,8,10,5,11,19,9,6,8,7,19,10,4,10,5,4,70,70,140,6,38,4.28571428571429,27.1428571428571,50,50
"50","17","2",2,6,9,7,9,14,11,8,6,10,14,11,7,11,8,4,67,73,140,6,28,4.28571428571429,20,52.1428571428571,47.8571428571429
"51","17","3",7,5,3,9,5,2,6,11,5,7,4,8,8,9,11,11,50,64,114,18,6,15.7894736842105,5.26315789473684,56.140350877193,43.859649122807
"52","17","4",7,7,6,7,5,13,10,4,6,6,12,7,8,6,4,4,61,54,115,11,25,9.56521739130435,21.7391304347826,46.9565217391304,53.0434782608696
"53","17","5",11,9,7,5,7,6,4,1,8,3,6,0,4,1,1,0,51,25,76,11,12,14.4736842105263,15.7894736842105,32.8947368421053,67.1052631578947
"54","17","6",3,4,3,3,2,7,5,4,4,3,5,6,5,4,4,4,33,36,69,7,12,10.1449275362319,17.3913043478261,52.1739130434783,47.8260869565217
"55","18","1",7,4,2,8,3,12,9,12,4,5,13,13,6,14,11,19,57,88,145,26,25,17.9310344827586,17.2413793103448,60.6896551724138,39.3103448275862
"56","18","2",3,6,10,6,9,13,8,12,6,10,12,15,7,13,12,30,68,107,175,33,25,18.8571428571429,14.2857142857143,61.1428571428571,38.8571428571429
"57","18","3",10,7,12,6,8,20,9,8,7,11,16,11,11,7,9,11,82,84,166,21,36,12.6506024096386,21.6867469879518,50.6024096385542,49.3975903614458
"58","18","4",8,4,10,7,6,18,14,8,4,13,14,15,11,11,8,3,76,81,157,11,32,7.00636942675159,20.3821656050955,51.5923566878981,48.4076433121019
"59","18","5",4,6,8,9,8,18,14,3,6,10,19,8,8,9,3,0,72,64,136,4,37,2.94117647058824,27.2058823529412,47.0588235294118,52.9411764705882
"60","18","6",7,6,11,5,8,18,11,0,6,11,15,6,9,3,0,0,68,51,119,7,33,5.88235294117647,27.7310924369748,42.8571428571429,57.1428571428571
"61","19","1",5,10,10,8,14,19,13,5,10,8,23,11,4,15,5,3,85,81,166,8,42,4.81927710843374,25.3012048192771,48.7951807228916,51.2048192771084
"62","19","2",2,4,10,4,6,18,7,10,4,10,13,13,8,8,9,22,61,90,151,24,31,15.8940397350993,20.5298013245033,59.6026490066225,40.3973509933775
"63","19","3",2,3,3,11,4,7,10,13,3,11,8,12,10,12,13,19,54,90,144,21,15,14.5833333333333,10.4166666666667,62.5,37.5
"64","19","4",4,4,8,4,8,7,4,10,5,8,7,10,4,10,10,28,52,82,134,32,14,23.8805970149254,10.4477611940299,61.1940298507463,38.8059701492537
"65","19","5",14,11,8,8,8,3,7,10,10,5,3,9,7,9,9,16,69,71,140,30,6,21.4285714285714,4.28571428571429,50.7142857142857,49.2857142857143
"66","19","6",0,3,3,8,1,2,4,15,3,8,0,12,10,10,15,63,37,123,160,63,2,39.375,1.25,76.875,23.125
"67","2","1",8,12,7,19,10,20,20,14,12,13,23,15,15,19,14,9,111,122,233,17,43,7.29613733905579,18.4549356223176,52.3605150214592,47.6394849785408
"68","2","2",9,9,10,10,13,23,14,10,9,11,26,13,8,16,10,14,100,108,208,23,49,11.0576923076923,23.5576923076923,51.9230769230769,48.0769230769231
"69","2","3",7,12,18,11,13,13,8,17,12,17,8,15,15,10,17,20,100,116,216,27,21,12.5,9.72222222222222,53.7037037037037,46.2962962962963
"70","2","4",0,4,3,11,2,10,6,22,4,10,8,17,12,15,21,52,58,142,200,52,18,26,9,71,29
"71","2","5",2,7,9,8,9,13,9,20,7,10,13,21,7,21,19,43,77,144,221,45,26,20.3619909502262,11.7647058823529,65.158371040724,34.841628959276
"72","2","6",0,5,6,12,5,13,10,18,5,13,12,16,13,15,18,34,69,129,198,34,25,17.1717171717172,12.6262626262626,65.1515151515152,34.8484848484849
"73","20","1",4,5,6,9,7,7,8,11,5,10,7,10,8,10,10,7,57,70,127,11,14,8.66141732283465,11.0236220472441,55.1181102362205,44.8818897637795
"74","20","2",2,7,9,3,8,12,6,6,7,5,10,9,4,7,6,8,54,58,112,10,22,8.92857142857143,19.6428571428571,51.7857142857143,48.2142857142857
"75","20","3",3,7,5,13,8,23,10,7,7,11,26,4,11,6,7,8,78,81,159,11,49,6.91823899371069,30.8176100628931,50.9433962264151,49.0566037735849
"76","20","4",4,9,12,5,12,20,4,5,9,8,21,4,5,4,5,4,73,61,134,8,41,5.97014925373134,30.5970149253731,45.5223880597015,54.4776119402985
"77","20","5",3,4,8,9,8,12,12,8,4,13,12,10,9,10,7,5,64,73,137,8,24,5.83941605839416,17.5182481751825,53.2846715328467,46.7153284671533
"78","20","6",6,3,6,6,7,13,8,7,3,9,14,9,5,10,7,11,57,70,127,17,27,13.3858267716535,21.259842519685,55.1181102362205,44.8818897637795
"79","21","1",3,2,4,8,3,12,11,8,1,10,11,11,8,11,8,15,52,77,129,18,23,13.953488372093,17.8294573643411,59.6899224806202,40.3100775193798
"80","21","2",6,4,5,3,5,15,9,9,4,4,15,15,3,15,9,24,57,91,148,30,30,20.2702702702703,20.2702702702703,61.4864864864865,38.5135135135135
"81","21","3",0,0,1,2,1,13,2,9,0,3,13,9,2,10,10,30,29,79,108,30,26,27.7777777777778,24.0740740740741,73.1481481481482,26.8518518518519
"82","21","4",1,2,5,3,4,20,2,9,2,6,20,8,3,8,9,6,48,63,111,7,40,6.30630630630631,36.036036036036,56.7567567567568,43.2432432432432
"83","21","5",1,1,3,3,3,26,4,6,1,5,26,7,3,7,6,7,49,63,112,8,52,7.14285714285714,46.4285714285714,56.25,43.75
"84","21","6",0,0,0,0,0,32,0,5,0,0,32,5,0,4,5,5,38,53,91,5,64,5.49450549450549,70.3296703296703,58.2417582417582,41.7582417582418
"85","22","1",14,11,18,6,16,16,11,7,11,13,15,12,8,11,8,5,101,84,185,19,31,10.2702702702703,16.7567567567568,45.4054054054054,54.5945945945946
"86","22","2",25,11,13,4,13,23,5,4,11,6,23,5,4,4,4,0,99,59,158,25,46,15.8227848101266,29.1139240506329,37.3417721518987,62.6582278481013
"87","22","3",5,6,6,6,5,20,5,7,6,6,19,6,7,5,7,2,62,59,121,7,39,5.78512396694215,32.2314049586777,48.7603305785124,51.2396694214876
"88","22","4",15,9,12,8,8,11,8,8,9,11,7,9,11,5,8,9,80,71,151,24,18,15.8940397350993,11.9205298013245,47.0198675496689,52.9801324503311
"89","22","5",15,5,9,2,8,11,2,5,5,6,9,6,3,4,5,7,58,47,105,22,20,20.952380952381,19.047619047619,44.7619047619048,55.2380952380952
"90","22","6",2,4,4,4,4,15,7,6,4,4,15,9,4,9,6,3,47,56,103,5,30,4.85436893203883,29.126213592233,54.3689320388349,45.6310679611651
"91","23","1",10,6,5,4,4,2,3,3,6,4,0,2,6,0,3,1,39,23,62,11,2,17.741935483871,3.2258064516129,37.0967741935484,62.9032258064516
"92","23","2",6,7,4,3,4,0,0,4,7,1,0,1,4,1,4,6,30,25,55,12,0,21.8181818181818,0,45.4545454545455,54.5454545454545
"93","23","3",1,6,5,3,3,3,1,6,6,2,2,4,4,3,6,1,30,29,59,2,5,3.38983050847458,8.47457627118644,49.1525423728814,50.8474576271186
"94","23","4",7,7,5,5,4,2,4,3,6,3,1,3,5,2,3,1,38,26,64,8,3,12.5,4.6875,40.625,59.375
"95","23","5",6,3,4,1,2,5,1,2,3,1,3,2,2,1,2,5,25,21,46,11,8,23.9130434782609,17.3913043478261,45.6521739130435,54.3478260869565
"96","23","6",3,1,2,2,4,3,2,1,2,2,5,1,0,3,1,1,21,15,36,4,8,11.1111111111111,22.2222222222222,41.6666666666667,58.3333333333333
"97","24","1",0,3,2,6,3,3,7,10,3,5,4,10,5,11,9,7,34,57,91,7,7,7.69230769230769,7.69230769230769,62.6373626373626,37.3626373626374
"98","24","2",2,3,1,7,2,6,8,6,3,5,7,7,6,8,6,3,38,45,83,5,13,6.02409638554217,15.6626506024096,54.2168674698795,45.7831325301205
"99","24","3",2,4,2,5,0,4,3,9,4,3,2,7,8,5,10,3,31,43,74,5,6,6.75675675675676,8.10810810810811,58.1081081081081,41.8918918918919
"100","24","4",3,5,5,4,6,2,6,2,6,4,2,4,4,4,2,1,36,27,63,4,4,6.34920634920635,6.34920634920635,42.8571428571429,57.1428571428571
"101","24","5",8,2,4,3,6,11,4,3,2,5,12,4,1,6,3,1,42,36,78,9,23,11.5384615384615,29.4871794871795,46.1538461538462,53.8461538461538
"102","24","6",0,2,6,5,5,5,8,2,1,9,4,5,5,5,2,3,34,36,70,3,9,4.28571428571429,12.8571428571429,51.4285714285714,48.5714285714286
"103","25","1",5,3,7,2,5,11,4,2,3,5,9,4,3,2,1,5,39,35,74,10,20,13.5135135135135,27.027027027027,47.2972972972973,52.7027027027027
"104","25","2",2,3,4,1,4,14,2,2,3,2,14,3,1,3,2,5,34,34,68,7,28,10.2941176470588,41.1764705882353,50,50
"105","25","3",0,3,3,3,2,4,4,3,3,3,3,4,4,2,3,9,23,33,56,9,7,16.0714285714286,12.5,58.9285714285714,41.0714285714286
"106","25","4",1,4,1,3,1,1,3,5,4,0,1,5,2,5,4,11,19,35,54,12,2,22.2222222222222,3.7037037037037,64.8148148148148,35.1851851851852
"107","25","5",8,3,2,4,2,5,3,2,3,3,5,2,4,2,3,5,30,29,59,13,10,22.0338983050847,16.9491525423729,49.1525423728814,50.8474576271186
"108","25","6",3,4,7,1,7,3,1,1,5,4,3,1,2,1,2,1,30,19,49,4,6,8.16326530612245,12.2448979591837,38.7755102040816,61.2244897959184
"109","26","1",1,3,2,3,2,5,5,4,3,2,4,6,3,5,4,7,26,36,62,8,9,12.9032258064516,14.5161290322581,58.0645161290323,41.9354838709677
"110","26","2",0,2,2,4,6,11,3,2,2,4,15,1,1,4,2,0,32,30,62,0,26,0,41.9354838709677,48.3870967741936,51.6129032258064
"111","26","3",3,4,5,3,6,9,6,2,4,4,10,4,2,5,2,0,39,33,72,3,19,4.16666666666667,26.3888888888889,45.8333333333333,54.1666666666667
"112","26","4",2,2,8,2,6,37,1,3,2,7,35,2,3,1,3,2,62,57,119,4,72,3.36134453781513,60.5042016806723,47.8991596638655,52.1008403361345
"113","26","5",1,3,9,0,7,156,2,1,3,6,154,4,1,2,1,2,180,175,355,3,310,0.845070422535211,87.3239436619718,49.2957746478873,50.7042253521127
"114","26","6",0,2,6,0,4,83,4,4,2,3,81,8,2,6,4,0,105,107,212,0,164,0,77.3584905660377,50.4716981132075,49.5283018867925
"115","27","1",13,11,15,8,19,29,8,10,11,11,33,10,3,14,9,9,113,103,216,22,62,10.1851851851852,28.7037037037037,47.6851851851852,52.3148148148148
"116","27","2",9,8,9,10,14,29,10,12,9,11,33,12,6,16,12,14,104,113,217,23,62,10.5990783410138,28.5714285714286,52.073732718894,47.926267281106
"117","27","3",12,12,11,11,13,16,9,12,12,10,18,10,9,12,12,22,98,106,204,34,34,16.6666666666667,16.6666666666667,51.9607843137255,48.0392156862745
"118","27","4",6,17,19,9,20,12,8,9,17,11,13,7,9,8,9,6,102,81,183,12,25,6.55737704918033,13.6612021857923,44.2622950819672,55.7377049180328
"119","27","5",20,11,9,11,13,6,12,6,11,9,10,7,7,10,6,8,89,70,159,28,16,17.6100628930818,10.062893081761,44.0251572327044,55.9748427672956
"120","27","6",7,8,11,10,8,13,9,12,9,13,10,11,14,7,12,6,81,82,163,13,23,7.97546012269939,14.1104294478528,50.3067484662577,49.6932515337423
"121","28","1",8,7,13,8,9,12,11,9,8,14,8,12,13,8,9,8,80,80,160,16,20,10,12.5,50,50
"122","28","2",24,14,13,9,11,6,8,6,13,8,4,5,11,3,6,4,93,55,148,28,10,18.9189189189189,6.75675675675676,37.1621621621622,62.8378378378378
"123","28","3",8,11,11,9,15,5,9,6,12,9,9,5,6,9,6,1,77,57,134,9,14,6.71641791044776,10.4477611940299,42.5373134328358,57.4626865671642
"124","28","4",8,7,8,5,9,10,5,4,7,6,11,4,5,5,4,3,58,46,104,11,21,10.5769230769231,20.1923076923077,44.2307692307692,55.7692307692308
"125","28","5",10,7,8,7,8,9,5,4,8,8,9,2,7,2,4,2,61,42,103,12,18,11.6504854368932,17.4757281553398,40.7766990291262,59.2233009708738
"126","28","6",17,8,12,5,8,13,11,5,8,9,9,11,9,7,5,2,82,60,142,19,22,13.3802816901408,15.4929577464789,42.2535211267606,57.7464788732394
"127","29","1",5,8,5,6,5,10,11,6,8,2,10,11,5,11,6,2,57,57,114,7,20,6.14035087719298,17.5438596491228,50,50
"128","29","2",6,8,12,7,12,21,7,8,8,11,20,8,7,8,8,7,82,79,161,13,41,8.07453416149068,25.4658385093168,49.0683229813665,50.9316770186335
"129","29","3",15,14,22,5,22,13,7,2,14,12,13,4,4,4,2,0,101,55,156,15,26,9.61538461538461,16.6666666666667,35.2564102564103,64.7435897435897
"130","29","4",11,11,13,6,13,15,10,2,12,8,15,6,7,6,2,0,84,56,140,11,30,7.85714285714286,21.4285714285714,40,60
"131","29","5",16,11,11,2,8,12,5,6,11,2,9,9,5,6,6,6,73,55,128,22,21,17.1875,16.40625,42.96875,57.03125
"132","29","6",15,6,9,3,10,16,5,5,5,7,17,7,2,8,5,5,71,57,128,20,33,15.625,25.78125,44.53125,55.46875
"133","3","1",15,10,11,11,13,16,8,11,10,12,18,8,8,10,10,10,95,89,184,25,34,13.5869565217391,18.4782608695652,48.3695652173913,51.6304347826087
"134","3","2",14,9,14,11,14,10,10,9,9,16,10,7,11,7,8,3,91,74,165,17,20,10.3030303030303,12.1212121212121,44.8484848484849,55.1515151515151
"135","3","3",3,5,10,8,4,15,10,8,4,13,9,10,13,4,7,7,63,70,133,10,24,7.5187969924812,18.0451127819549,52.6315789473684,47.3684210526316
"136","3","4",6,5,5,5,4,5,9,2,5,5,4,6,6,4,2,1,42,35,77,7,9,9.09090909090909,11.6883116883117,45.4545454545455,54.5454545454545
"137","3","5",3,3,2,2,2,4,0,6,3,1,4,5,2,5,6,2,23,30,53,5,8,9.43396226415094,15.0943396226415,56.6037735849057,43.3962264150943
"138","3","6",0,1,1,2,1,3,0,7,1,2,3,5,2,5,7,18,16,45,61,18,6,29.5081967213115,9.83606557377049,73.7704918032787,26.2295081967213
"139","30","1",16,10,10,6,8,13,6,8,10,6,11,8,9,6,9,13,79,73,152,29,24,19.0789473684211,15.7894736842105,48.0263157894737,51.9736842105263
"140","30","2",17,8,16,7,13,15,11,3,8,15,13,7,9,5,3,1,92,62,154,18,28,11.6883116883117,18.1818181818182,40.2597402597403,59.7402597402597
"141","30","3",2,7,14,6,12,15,9,6,7,13,13,9,8,8,6,4,72,70,142,6,28,4.22535211267606,19.7183098591549,49.2957746478873,50.7042253521127
"142","30","4",7,8,7,6,7,10,8,6,8,5,11,7,6,8,6,3,61,55,116,10,21,8.62068965517241,18.1034482758621,47.4137931034483,52.5862068965517
"143","30","5",8,7,13,4,12,15,8,3,7,9,15,7,4,7,3,1,72,54,126,9,30,7.14285714285714,23.8095238095238,42.8571428571429,57.1428571428571
"144","30","6",8,7,8,8,8,14,14,5,7,9,14,12,8,11,5,9,73,77,150,17,28,11.3333333333333,18.6666666666667,51.3333333333333,48.6666666666667
"145","31","1",8,3,4,0,1,5,2,3,3,1,2,5,3,2,3,7,26,29,55,15,7,27.2727272727273,12.7272727272727,52.7272727272727,47.2727272727273
"146","31","2",8,10,7,5,9,2,6,1,10,2,5,2,3,5,1,2,50,31,81,10,7,12.3456790123457,8.64197530864197,38.2716049382716,61.7283950617284
"147","31","3",6,4,2,4,3,3,4,5,4,2,3,5,4,5,5,4,33,33,66,10,6,15.1515151515152,9.09090909090909,50,50
"148","31","4",7,5,5,4,5,6,2,4,5,4,6,3,4,2,4,8,39,38,77,15,12,19.4805194805195,15.5844155844156,49.3506493506493,50.6493506493507
"149","31","5",3,2,5,7,5,3,5,7,2,10,3,5,6,5,7,10,38,50,88,13,6,14.7727272727273,6.81818181818182,56.8181818181818,43.1818181818182
"150","31","6",0,0,0,2,0,0,2,1,0,1,1,1,1,2,1,1,7,9,16,1,1,6.25,6.25,56.25,43.75
"151","32","1",10,9,16,9,11,19,13,7,9,16,14,11,14,6,7,2,96,80,176,12,33,6.81818181818182,18.75,45.4545454545455,54.5454545454545
"152","32","2",25,12,9,7,11,14,5,4,12,3,17,2,4,5,4,3,89,51,140,28,31,20,22.1428571428571,36.4285714285714,63.5714285714286
"153","32","3",12,6,9,14,11,13,13,9,6,16,15,8,12,10,9,12,89,89,178,24,28,13.4831460674157,15.7303370786517,50,50
"154","32","4",13,9,7,8,9,15,6,11,9,6,17,9,6,12,11,25,79,97,176,38,32,21.5909090909091,18.1818181818182,55.1136363636364,44.8863636363636
"155","32","5",2,6,6,7,7,18,5,14,6,7,18,12,6,12,13,15,65,92,157,17,36,10.828025477707,22.9299363057325,58.5987261146497,41.4012738853503
"156","32","6",0,3,2,9,5,10,7,12,3,8,13,11,6,14,12,17,49,86,135,17,23,12.5925925925926,17.037037037037,63.7037037037037,36.2962962962963
"157","33","1",27,14,24,3,22,18,4,0,14,13,17,1,5,0,0,0,114,51,165,27,35,16.3636363636364,21.2121212121212,30.9090909090909,69.0909090909091
"158","33","2",36,20,25,3,27,11,2,1,20,8,13,0,1,2,1,0,127,46,173,36,24,20.8092485549133,13.8728323699422,26.5895953757225,73.4104046242775
"159","33","3",53,18,20,4,22,4,2,2,17,6,6,0,1,3,2,1,126,38,164,54,10,32.9268292682927,6.09756097560976,23.1707317073171,76.8292682926829
"160","33","4",78,12,14,6,13,8,5,4,13,8,7,3,8,2,5,3,143,49,192,81,15,42.1875,7.8125,25.5208333333333,74.4791666666667
"161","33","5",20,16,15,11,19,3,7,7,15,11,7,3,7,7,7,3,100,61,161,23,10,14.2857142857143,6.2111801242236,37.888198757764,62.111801242236
"162","33","6",57,16,18,5,19,7,4,2,17,7,8,1,4,2,2,2,131,43,174,59,15,33.9080459770115,8.62068965517241,24.7126436781609,75.2873563218391
"163","34","1",7,3,2,5,1,3,1,8,3,4,3,4,5,4,8,1,32,33,65,8,6,12.3076923076923,9.23076923076923,50.7692307692308,49.2307692307692
"164","34","2",5,8,5,12,8,6,11,10,8,9,9,9,9,12,10,15,68,81,149,20,15,13.4228187919463,10.0671140939597,54.3624161073826,45.6375838926174
"165","34","3",2,3,3,3,2,14,9,8,3,3,13,14,4,14,9,22,45,84,129,24,27,18.6046511627907,20.9302325581395,65.1162790697674,34.8837209302326
"166","34","4",0,3,3,6,4,10,6,13,3,6,11,13,6,14,13,18,47,85,132,18,21,13.6363636363636,15.9090909090909,64.3939393939394,35.6060606060606
"167","34","5",5,6,8,2,5,18,5,5,6,4,15,8,5,5,5,7,56,56,112,12,33,10.7142857142857,29.4642857142857,50,50
"168","34","6",12,10,12,5,13,11,7,3,10,7,12,5,4,6,3,3,74,52,126,15,23,11.9047619047619,18.2539682539683,41.2698412698413,58.7301587301587
"169","35","1",8,8,12,10,11,21,15,10,8,14,21,15,10,15,10,5,97,99,196,13,42,6.63265306122449,21.4285714285714,50.5102040816327,49.4897959183673
"170","35","2",1,4,9,5,5,28,13,7,4,10,23,15,9,11,7,5,73,86,159,6,51,3.77358490566038,32.0754716981132,54.0880503144654,45.9119496855346
"171","35","3",4,6,5,6,4,10,7,12,6,5,9,13,7,12,12,15,54,82,136,19,19,13.9705882352941,13.9705882352941,60.2941176470588,39.7058823529412
"172","35","4",0,0,3,3,3,14,7,14,0,6,14,18,3,18,15,30,45,106,151,30,28,19.8675496688742,18.5430463576159,70.1986754966887,29.8013245033113
"173","35","5",0,0,1,0,0,5,6,12,0,1,4,18,1,16,12,29,25,83,108,29,9,26.8518518518519,8.33333333333333,76.8518518518518,23.1481481481481
"174","35","6",1,1,3,2,1,16,5,6,1,3,15,9,3,8,6,4,37,50,87,5,31,5.74712643678161,35.632183908046,57.4712643678161,42.5287356321839
"175","36","1",2,4,5,3,4,18,5,4,4,4,16,6,4,4,4,4,46,48,94,6,34,6.38297872340426,36.1702127659574,51.063829787234,48.936170212766
"176","36","2",5,8,3,8,4,15,9,7,8,3,16,9,7,10,8,8,60,71,131,13,31,9.9236641221374,23.6641221374046,54.1984732824427,45.8015267175573
"177","36","3",12,7,7,2,5,14,5,3,7,2,12,6,4,5,3,7,56,48,104,19,26,18.2692307692308,25,46.1538461538462,53.8461538461538
"178","36","4",0,0,2,3,1,10,3,3,0,5,9,3,3,2,3,5,23,32,55,5,19,9.09090909090909,34.5454545454545,58.1818181818182,41.8181818181818
"179","36","5",0,0,1,0,2,3,1,0,0,2,4,1,0,1,0,0,9,9,18,0,7,0,38.8888888888889,50,50
"180","36","6",0,0,0,1,0,2,1,0,0,1,1,1,1,0,0,0,5,6,11,0,3,0,27.2727272727273,54.5454545454545,45.4545454545455
"181","37","1",14,12,15,11,17,13,12,4,12,14,15,5,9,8,4,4,99,73,172,18,28,10.4651162790698,16.2790697674419,42.4418604651163,57.5581395348837
"182","37","2",5,9,19,4,20,44,7,2,9,15,45,4,4,5,2,2,112,87,199,7,89,3.51758793969849,44.7236180904523,43.7185929648241,56.2814070351759
"183","37","3",28,16,18,9,18,22,8,7,16,12,21,6,10,5,7,6,128,84,212,34,43,16.0377358490566,20.2830188679245,39.622641509434,60.377358490566
"184","37","4",23,16,10,11,11,15,7,11,16,5,16,7,10,9,12,8,105,85,190,31,31,16.3157894736842,16.3157894736842,44.7368421052632,55.2631578947368
"185","37","5",20,13,21,4,19,30,8,7,13,12,28,11,6,9,7,6,124,93,217,26,58,11.9815668202765,26.7281105990783,42.8571428571429,57.1428571428571
"186","37","6",17,7,18,9,13,23,15,8,7,20,19,14,13,10,8,8,112,100,212,25,42,11.7924528301887,19.811320754717,47.1698113207547,52.8301886792453
"187","38","1",9,5,5,3,3,17,6,2,5,3,15,5,5,4,2,4,51,45,96,13,32,13.5416666666667,33.3333333333333,46.875,53.125
"188","38","2",20,8,12,2,11,16,5,1,8,6,14,5,3,3,1,0,76,42,118,20,30,16.9491525423729,25.4237288135593,35.5932203389831,64.406779661017
"189","38","3",18,2,3,0,3,6,1,0,3,1,6,1,1,1,1,2,36,16,52,20,12,38.4615384615385,23.0769230769231,30.7692307692308,69.2307692307692
"190","38","4",8,5,7,1,5,4,1,1,4,3,2,1,2,0,1,0,33,15,48,8,6,16.6666666666667,12.5,31.25,68.75
"191","38","5",2,2,3,0,2,12,1,0,2,1,11,1,1,0,0,0,24,17,41,2,23,4.8780487804878,56.0975609756098,41.4634146341463,58.5365853658537
"192","38","6",0,0,3,0,1,8,2,0,0,3,7,2,2,1,0,0,16,16,32,0,15,0,46.875,50,50
"193","39","1",1,4,19,6,20,25,18,2,4,21,26,14,5,15,2,1,96,90,186,2,51,1.0752688172043,27.4193548387097,48.3870967741936,51.6129032258064
"194","39","2",4,8,10,16,13,16,13,14,8,18,19,10,13,14,14,9,95,107,202,13,35,6.43564356435644,17.3267326732673,52.970297029703,47.029702970297
"195","39","3",11,15,19,12,19,17,9,12,15,16,17,9,12,10,12,7,115,100,215,18,34,8.37209302325581,15.8139534883721,46.5116279069767,53.4883720930233
"196","39","4",8,8,14,8,16,26,12,7,8,14,28,11,7,12,7,12,101,100,201,20,54,9.9502487562189,26.865671641791,49.7512437810945,50.2487562189055
"197","39","5",11,8,11,7,9,22,9,10,8,10,19,12,9,9,9,7,87,86,173,18,41,10.4046242774566,23.6994219653179,49.7109826589595,50.2890173410405
"198","39","6",0,2,7,6,8,24,12,18,2,11,25,24,5,25,18,29,78,141,219,29,49,13.2420091324201,22.3744292237443,64.3835616438356,35.6164383561644
"199","4","1",24,13,16,11,15,20,12,8,12,14,19,9,12,8,8,11,121,94,215,35,39,16.2790697674419,18.1395348837209,43.7209302325581,56.2790697674419
"200","4","2",24,12,9,9,10,7,10,8,12,6,9,9,8,11,8,9,91,73,164,33,16,20.1219512195122,9.75609756097561,44.5121951219512,55.4878048780488
"201","4","3",12,9,10,10,7,8,10,10,9,10,5,10,12,7,10,2,77,67,144,14,13,9.72222222222222,9.02777777777778,46.5277777777778,53.4722222222222
"202","4","4",14,12,11,6,11,11,7,6,12,5,11,7,6,7,6,2,80,57,137,16,22,11.6788321167883,16.0583941605839,41.6058394160584,58.3941605839416
"203","4","5",20,12,14,5,12,9,5,2,11,7,8,2,6,1,2,2,81,40,121,22,17,18.1818181818182,14.0495867768595,33.0578512396694,66.9421487603306
"204","4","6",20,7,11,1,10,6,4,0,7,6,5,2,3,1,0,0,61,25,86,20,11,23.2558139534884,12.7906976744186,29.0697674418605,70.9302325581395
"205","40","1",6,7,11,8,14,7,10,3,8,12,10,5,5,8,3,5,69,56,125,11,17,8.8,13.6,44.8,55.2
"206","40","2",6,11,11,7,9,17,8,4,11,6,15,5,8,4,4,2,74,57,131,8,32,6.10687022900763,24.4274809160305,43.5114503816794,56.4885496183206
"207","40","3",14,9,12,3,11,13,3,2,9,6,12,2,4,1,3,2,68,41,109,16,25,14.6788990825688,22.9357798165138,37.6146788990826,62.3853211009174
"208","40","4",9,8,11,5,11,7,6,3,8,7,7,4,4,5,3,0,61,40,101,9,14,8.91089108910891,13.8613861386139,39.6039603960396,60.3960396039604
"209","40","5",4,2,9,4,11,17,6,2,2,11,20,4,2,6,2,2,57,50,107,6,37,5.60747663551402,34.5794392523364,46.7289719626168,53.2710280373832
"210","40","6",2,5,7,5,6,7,10,4,5,7,6,9,6,8,4,3,47,50,97,5,13,5.15463917525773,13.4020618556701,51.5463917525773,48.4536082474227
"211","41","1",5,7,7,5,6,22,6,6,7,5,21,7,6,7,6,10,65,71,136,15,43,11.0294117647059,31.6176470588235,52.2058823529412,47.7941176470588
"212","41","2",20,13,11,7,11,13,7,6,12,5,13,7,6,7,6,1,89,59,148,21,26,14.1891891891892,17.5675675675676,39.8648648648649,60.1351351351351
"213","41","3",6,7,16,5,12,14,9,4,7,14,11,7,9,4,4,2,75,59,134,8,25,5.97014925373134,18.6567164179104,44.0298507462687,55.9701492537313
"214","41","4",12,8,5,7,9,4,6,5,8,5,8,3,4,7,5,13,58,54,112,25,12,22.3214285714286,10.7142857142857,48.2142857142857,51.7857142857143
"215","41","5",12,5,5,7,5,16,6,7,5,7,15,6,7,6,7,8,64,63,127,20,31,15.748031496063,24.4094488188976,49.6062992125984,50.3937007874016
"216","41","6",6,4,8,6,8,12,6,4,4,10,11,4,7,3,4,3,56,47,103,9,23,8.7378640776699,22.3300970873786,45.6310679611651,54.3689320388349
"217","42","1",8,7,13,4,14,11,12,5,8,10,12,12,4,13,5,5,77,69,146,13,23,8.9041095890411,15.7534246575342,47.2602739726027,52.7397260273973
"218","42","2",10,6,7,4,7,8,6,6,6,4,8,8,3,8,5,6,54,51,105,16,16,15.2380952380952,15.2380952380952,48.5714285714286,51.4285714285714
"219","42","3",4,3,2,3,4,9,4,7,3,3,10,8,2,9,7,14,38,57,95,18,19,18.9473684210526,20,60,40
"220","42","4",10,9,10,13,11,10,15,9,9,14,11,11,12,12,9,6,90,84,174,16,21,9.19540229885057,12.0689655172414,48.2758620689655,51.7241379310345
"221","42","5",4,6,8,3,6,20,4,4,6,5,18,5,5,3,4,5,58,51,109,9,38,8.25688073394495,34.8623853211009,46.7889908256881,53.2110091743119
"222","42","6",1,3,6,5,7,14,6,5,3,8,15,7,4,7,5,4,48,55,103,5,29,4.85436893203883,28.1553398058252,53.3980582524272,46.6019417475728
"223","43","1",6,6,7,5,8,7,5,2,5,6,8,2,4,3,2,0,48,31,79,6,15,7.59493670886076,18.9873417721519,39.2405063291139,60.7594936708861
"224","43","2",56,11,12,3,13,1,2,1,12,3,2,0,2,1,1,1,102,22,124,57,3,45.9677419354839,2.41935483870968,17.741935483871,82.258064516129
"225","43","3",43,8,8,1,9,6,1,0,9,1,6,0,1,0,0,0,79,17,96,43,12,44.7916666666667,12.5,17.7083333333333,82.2916666666667
"226","43","4",21,9,12,1,10,16,3,0,8,4,14,2,2,1,0,0,73,33,106,21,30,19.811320754717,28.3018867924528,31.1320754716981,68.8679245283019
"227","43","5",36,6,7,0,6,12,1,0,6,1,11,1,1,0,0,0,70,21,91,36,23,39.5604395604396,25.2747252747253,23.0769230769231,76.9230769230769
"228","43","6",31,7,7,0,5,11,2,0,6,1,9,2,2,0,0,0,65,21,86,31,20,36.046511627907,23.2558139534884,24.4186046511628,75.5813953488372
"229","44","1",8,9,13,10,14,21,16,11,9,14,21,17,9,17,10,6,102,106,208,14,42,6.73076923076923,20.1923076923077,50.9615384615385,49.0384615384615
"230","44","2",9,12,9,13,12,14,17,12,12,10,16,16,10,18,12,11,99,107,206,20,30,9.70873786407767,14.5631067961165,51.9417475728155,48.0582524271845
"231","44","3",6,12,9,9,10,14,14,11,13,6,15,16,8,17,11,10,88,96,184,16,29,8.69565217391304,15.7608695652174,52.1739130434783,47.8260869565217
"232","44","4",17,13,11,10,12,6,7,7,13,8,7,5,9,5,7,3,84,59,143,20,13,13.986013986014,9.09090909090909,41.2587412587413,58.7412587412587
"233","44","5",20,7,7,7,6,10,10,3,6,7,9,6,7,5,2,6,70,51,121,26,19,21.4876033057851,15.702479338843,42.1487603305785,57.8512396694215
"234","44","6",0,0,2,3,1,10,2,11,0,5,9,10,4,8,10,23,29,72,101,23,19,22.7722772277228,18.8118811881188,71.2871287128713,28.7128712871287
"235","45","1",6,7,12,5,12,19,4,8,8,10,19,7,6,6,8,9,76,73,149,15,38,10.0671140939597,25.503355704698,48.993288590604,51.006711409396
"236","45","2",1,2,4,8,3,8,6,16,2,10,7,14,8,13,16,12,49,84,133,13,15,9.77443609022556,11.2781954887218,63.1578947368421,36.8421052631579
"237","45","3",7,7,10,6,10,11,6,7,7,10,11,7,7,7,7,0,66,57,123,7,22,5.69105691056911,17.8861788617886,46.3414634146341,53.6585365853659
"238","45","4",8,8,4,10,4,5,15,5,8,6,5,10,10,9,4,3,59,58,117,11,10,9.4017094017094,8.54700854700855,49.5726495726496,50.4273504273504
"239","45","5",7,4,2,4,5,5,1,9,4,3,7,6,2,8,9,34,39,74,113,41,12,36.283185840708,10.6194690265487,65.4867256637168,34.5132743362832
"240","45","6",0,1,0,2,0,8,6,11,1,1,7,15,2,14,10,35,28,88,116,35,15,30.1724137931034,12.9310344827586,75.8620689655172,24.1379310344828
"241","46","1",21,10,14,5,12,18,5,4,10,9,16,4,7,2,4,5,91,58,149,26,34,17.4496644295302,22.8187919463087,38.9261744966443,61.0738255033557
"242","46","2",18,12,17,7,16,13,10,2,11,12,12,5,7,5,2,5,96,61,157,23,25,14.6496815286624,15.9235668789809,38.8535031847134,61.1464968152866
"243","46","3",1,4,9,7,13,21,7,2,4,12,25,2,3,5,2,1,65,56,121,2,46,1.65289256198347,38.0165289256198,46.2809917355372,53.7190082644628
"244","46","4",0,1,5,6,9,30,17,1,1,10,34,12,2,16,1,1,70,79,149,1,64,0.671140939597315,42.9530201342282,53.0201342281879,46.9798657718121
"245","46","5",0,0,3,1,2,33,12,3,0,4,32,13,2,13,3,3,55,72,127,3,65,2.36220472440945,51.1811023622047,56.6929133858268,43.3070866141732
"246","46","6",7,6,5,5,8,22,9,2,6,4,24,6,2,8,2,3,65,57,122,10,46,8.19672131147541,37.7049180327869,46.7213114754098,53.2786885245902
"247","47","1",12,11,11,10,14,15,12,6,11,10,18,8,7,11,6,5,93,77,170,17,33,10,19.4117647058824,45.2941176470588,54.7058823529412
"248","47","2",39,16,18,5,13,21,9,8,17,7,15,12,11,6,8,5,132,81,213,44,36,20.6572769953052,16.9014084507042,38.0281690140845,61.9718309859155
"249","47","3",33,25,20,13,22,16,10,7,25,8,18,4,11,6,7,4,148,84,232,37,34,15.948275862069,14.6551724137931,36.2068965517241,63.7931034482759
"250","47","4",9,9,13,11,12,14,11,10,9,15,13,10,12,8,10,10,90,89,179,19,27,10.6145251396648,15.0837988826816,49.7206703910615,50.2793296089385
"251","47","5",3,6,8,7,7,18,8,10,6,9,17,11,8,10,10,6,68,79,147,9,35,6.12244897959184,23.8095238095238,53.7414965986395,46.2585034013605
"252","47","6",4,8,15,8,12,20,10,9,8,15,16,11,11,7,8,4,86,83,169,8,36,4.73372781065089,21.301775147929,49.112426035503,50.887573964497
"253","48","1",5,1,7,0,3,19,7,4,1,6,15,12,4,7,4,6,47,57,104,11,34,10.5769230769231,32.6923076923077,54.8076923076923,45.1923076923077
"254","48","2",7,6,3,10,6,13,8,6,6,7,17,4,6,8,6,2,61,57,118,9,30,7.6271186440678,25.4237288135593,48.3050847457627,51.6949152542373
"255","48","3",8,9,9,4,10,9,2,4,8,5,10,2,3,3,4,4,57,40,97,12,19,12.3711340206186,19.5876288659794,41.2371134020619,58.7628865979381
"256","48","4",3,3,6,2,4,9,5,2,3,6,7,5,4,3,2,4,36,35,71,7,16,9.85915492957746,22.5352112676056,49.2957746478873,50.7042253521127
"257","48","5",3,4,0,6,1,1,4,3,4,3,2,1,6,1,3,0,24,21,45,3,3,6.66666666666667,6.66666666666667,46.6666666666667,53.3333333333333
"258","48","6",7,2,1,2,1,8,1,2,3,1,8,1,2,1,2,1,27,19,46,8,16,17.3913043478261,34.7826086956522,41.304347826087,58.695652173913
"259","49","1",11,12,15,10,12,18,11,12,12,13,15,14,13,10,12,18,102,109,211,29,33,13.7440758293839,15.6398104265403,51.6587677725119,48.3412322274881
"260","49","2",5,5,11,7,8,18,12,15,5,13,15,20,10,18,16,15,82,114,196,20,33,10.2040816326531,16.8367346938776,58.1632653061224,41.8367346938776
"261","49","3",4,8,9,8,6,9,7,12,7,9,7,11,10,9,12,20,65,86,151,24,16,15.8940397350993,10.5960264900662,56.953642384106,43.046357615894
"262","49","4",9,3,8,3,7,28,3,6,3,8,28,6,4,5,6,10,69,71,140,19,56,13.5714285714286,40,50.7142857142857,49.2857142857143
"263","49","5",18,8,7,2,9,9,2,0,8,2,11,0,1,1,0,0,57,24,81,18,20,22.2222222222222,24.6913580246914,29.6296296296296,70.3703703703704
"264","49","6",4,1,1,3,2,1,3,1,2,3,2,1,2,2,1,0,19,13,32,4,3,12.5,9.375,40.625,59.375
"265","5","1",12,10,10,12,10,13,14,9,10,12,13,11,12,11,9,5,93,83,176,17,26,9.65909090909091,14.7727272727273,47.1590909090909,52.8409090909091
"266","5","2",14,9,13,2,11,30,10,3,9,6,29,10,4,9,3,12,94,83,177,26,59,14.6892655367232,33.3333333333333,46.8926553672316,53.1073446327684
"267","5","3",3,8,8,7,9,17,8,6,8,7,18,7,6,7,6,6,67,67,134,9,35,6.71641791044776,26.1194029850746,50,50
"268","5","4",17,11,11,7,12,15,5,5,11,7,16,4,5,5,5,4,84,59,143,21,31,14.6853146853147,21.6783216783217,41.2587412587413,58.7412587412587
"269","5","5",13,8,8,10,9,3,9,5,8,10,4,5,9,5,5,5,66,53,119,18,7,15.1260504201681,5.88235294117647,44.5378151260504,55.4621848739496
"270","5","6",19,11,20,2,17,8,4,4,10,11,5,6,4,4,4,1,86,47,133,20,13,15.0375939849624,9.77443609022556,35.3383458646617,64.6616541353384
"271","50","1",7,6,5,5,3,12,13,4,5,4,10,12,6,11,4,3,56,57,113,10,22,8.84955752212389,19.4690265486726,50.4424778761062,49.5575221238938
"272","50","2",0,0,1,2,2,30,6,0,0,3,31,4,1,5,0,0,43,45,88,0,61,0,69.3181818181818,51.1363636363636,48.8636363636364
"273","50","3",1,2,3,6,7,10,7,4,2,7,14,5,2,8,4,3,41,47,88,4,24,4.54545454545455,27.2727272727273,53.4090909090909,46.5909090909091
"274","50","4",6,4,2,3,4,3,3,2,4,1,5,2,2,3,2,0,29,20,49,6,8,12.2448979591837,16.3265306122449,40.8163265306122,59.1836734693878
"275","50","5",0,0,2,1,1,2,2,4,0,3,1,5,2,4,5,2,13,24,37,2,3,5.40540540540541,8.10810810810811,64.8648648648649,35.1351351351351
"276","50","6",0,2,4,1,1,8,4,2,2,3,5,5,4,2,2,5,24,29,53,5,13,9.43396226415094,24.5283018867925,54.7169811320755,45.2830188679245
"277","51","1",14,10,15,4,15,13,3,3,10,9,13,2,3,3,3,0,78,45,123,14,26,11.3821138211382,21.1382113821138,36.5853658536585,63.4146341463415
"278","51","2",6,10,13,11,13,7,8,6,10,14,6,3,11,2,5,3,74,57,131,9,13,6.87022900763359,9.9236641221374,43.5114503816794,56.4885496183206
"279","51","3",21,12,16,7,17,7,7,0,11,12,8,0,6,1,0,0,89,39,128,21,15,16.40625,11.71875,30.46875,69.53125
"280","51","4",7,7,13,2,14,28,3,0,7,8,29,1,1,2,0,0,76,49,125,7,57,5.6,45.6,39.2,60.8
"281","51","5",3,4,8,2,6,24,4,1,4,6,22,3,4,1,1,1,53,44,97,4,46,4.12371134020619,47.4226804123711,45.360824742268,54.639175257732
"282","51","6",5,5,6,3,6,21,5,1,5,4,21,3,3,3,1,0,53,42,95,5,42,5.26315789473684,44.2105263157895,44.2105263157895,55.7894736842105
"283","52","1",4,10,10,8,7,25,7,10,10,7,23,9,10,7,10,8,83,85,168,12,48,7.14285714285714,28.5714285714286,50.5952380952381,49.4047619047619
"284","52","2",1,8,9,6,11,26,8,8,8,7,27,11,4,12,8,1,78,80,158,2,53,1.26582278481013,33.5443037974684,50.6329113924051,49.3670886075949
"285","52","3",3,4,9,4,8,24,10,3,4,9,22,9,5,7,3,7,66,68,134,10,46,7.46268656716418,34.3283582089552,50.7462686567164,49.2537313432836
"286","52","4",4,4,4,4,7,20,6,6,4,4,22,8,1,11,6,3,56,61,117,7,42,5.98290598290598,35.8974358974359,52.1367521367521,47.8632478632479
"287","52","5",1,1,6,3,6,16,6,4,2,7,16,7,3,7,4,1,46,47,93,2,32,2.1505376344086,34.4086021505376,50.5376344086022,49.4623655913978
"288","52","6",4,3,5,3,5,10,6,1,3,5,11,4,3,4,1,0,39,32,71,4,21,5.63380281690141,29.5774647887324,45.0704225352113,54.9295774647887
"289","53","1",2,4,6,4,6,13,8,6,4,6,13,10,4,10,6,2,50,57,107,4,26,3.73831775700935,24.2990654205607,53.2710280373832,46.7289719626168
"290","53","2",0,3,6,4,5,24,10,4,3,7,23,10,5,9,4,3,56,67,123,3,47,2.4390243902439,38.2113821138211,54.4715447154472,45.5284552845528
"291","53","3",6,7,4,6,4,14,12,4,7,3,14,11,6,11,5,4,58,63,121,10,28,8.26446280991735,23.1404958677686,52.0661157024793,47.9338842975207
"292","53","4",3,2,6,5,6,21,6,8,2,9,22,8,5,9,8,16,59,80,139,19,43,13.6690647482014,30.9352517985612,57.5539568345324,42.4460431654676
"293","53","5",4,2,5,5,4,11,5,11,2,7,10,11,5,10,10,17,47,75,122,21,21,17.2131147540984,17.2131147540984,61.4754098360656,38.5245901639344
"294","53","6",9,8,9,4,9,14,6,6,9,5,14,7,5,7,6,8,68,61,129,17,28,13.1782945736434,21.7054263565891,47.2868217054264,52.7131782945736
"295","54","1",1,5,4,5,4,7,6,5,5,4,7,7,5,7,5,7,38,49,87,8,14,9.19540229885057,16.0919540229885,56.3218390804598,43.6781609195402
"296","54","2",1,2,3,1,4,14,4,8,2,2,14,12,0,12,8,9,38,61,99,10,28,10.1010101010101,28.2828282828283,61.6161616161616,38.3838383838384
"297","54","3",0,2,2,3,1,3,2,10,2,3,2,9,4,9,11,29,24,71,95,29,5,30.5263157894737,5.26315789473684,74.7368421052632,25.2631578947368
"298","54","4",0,1,3,4,4,9,6,4,1,6,11,6,3,8,5,19,33,60,93,19,20,20.4301075268817,21.505376344086,64.5161290322581,35.4838709677419
"299","54","5",0,0,4,4,3,11,9,6,0,8,10,10,5,9,5,6,37,56,93,6,21,6.45161290322581,22.5806451612903,60.2150537634409,39.7849462365591
"300","54","6",0,0,3,5,3,6,4,9,0,8,5,8,5,7,8,19,30,63,93,19,11,20.4301075268817,11.8279569892473,67.741935483871,32.258064516129
"301","55","1",1,6,5,6,4,11,9,8,6,5,11,11,7,11,8,16,52,76,128,17,22,13.28125,17.1875,59.375,40.625
"302","55","2",2,2,5,2,3,22,7,5,2,5,20,10,4,7,4,4,48,59,107,6,42,5.60747663551402,39.2523364485981,55.1401869158879,44.8598130841121
"303","55","3",0,0,0,0,0,4,1,9,0,0,4,10,0,10,9,36,14,72,86,36,8,41.8604651162791,9.30232558139535,83.7209302325581,16.2790697674419
"304","55","4",0,0,0,0,0,2,0,3,0,0,2,3,0,2,3,27,6,39,45,27,4,60,8.88888888888889,86.6666666666667,13.3333333333333
"305","55","5",0,0,0,0,0,3,2,3,0,0,3,5,0,5,3,5,8,24,32,5,6,15.625,18.75,75,25
"306","55","6",0,0,0,0,0,1,0,6,0,0,1,6,0,6,6,26,7,48,55,26,2,47.2727272727273,3.63636363636364,87.2727272727273,12.7272727272727
"307","56","1",1,2,2,0,1,1,0,0,1,0,0,0,0,0,0,0,8,3,11,1,1,9.09090909090909,9.09090909090909,27.2727272727273,72.7272727272727
"308","56","2",0,1,0,1,0,0,0,1,0,0,0,0,0,0,1,0,4,3,7,0,0,0,0,42.8571428571429,57.1428571428571
"309","56","3",0,0,1,0,0,1,1,0,0,0,0,1,0,1,0,0,4,4,8,0,1,0,12.5,50,50
"310","56","4",0,0,0,0,0,0,0,0,0,0,0,0,0,0,0,0,0,0,0,0,0,NA,NA,NA,NA
"311","56","5",0,0,0,0,0,0,0,0,0,0,0,0,0,0,0,0,0,0,0,0,0,NA,NA,NA,NA
"312","56","6",0,0,0,0,0,0,0,0,0,0,0,0,0,0,0,0,0,0,0,0,0,NA,NA,NA,NA
"313","57","1",2,4,3,8,3,9,6,7,4,7,9,5,8,5,7,15,43,62,105,17,18,16.1904761904762,17.1428571428571,59.0476190476191,40.9523809523809
"314","57","2",0,1,5,7,7,8,7,5,1,10,11,5,4,8,5,7,42,52,94,7,19,7.4468085106383,20.2127659574468,55.3191489361702,44.6808510638298
"315","57","3",4,3,6,4,7,9,2,3,3,7,10,1,3,2,3,7,39,38,77,11,19,14.2857142857143,24.6753246753247,49.3506493506493,50.6493506493507
"316","57","4",5,4,5,2,4,4,2,2,3,3,3,2,2,2,2,1,29,20,49,6,7,12.2448979591837,14.2857142857143,40.8163265306122,59.1836734693878
"317","57","5",3,3,2,3,1,5,3,2,2,2,4,2,4,1,2,5,24,23,47,8,9,17.0212765957447,19.1489361702128,48.936170212766,51.063829787234
"318","57","6",1,3,1,5,2,4,4,2,2,4,5,1,4,2,2,2,24,23,47,3,9,6.38297872340426,19.1489361702128,48.936170212766,51.063829787234
"319","58","1",20,13,14,9,15,11,11,2,13,9,12,4,7,6,2,1,96,56,152,21,23,13.8157894736842,15.1315789473684,36.8421052631579,63.1578947368421
"320","58","2",11,9,8,7,9,7,4,7,9,6,9,3,6,5,7,6,64,52,116,17,16,14.6551724137931,13.7931034482759,44.8275862068966,55.1724137931034
"321","58","3",0,3,3,7,3,9,6,11,3,7,10,10,6,11,11,36,44,95,139,36,19,25.8992805755396,13.6690647482014,68.3453237410072,31.6546762589928
"322","58","4",5,4,8,3,6,18,10,11,4,7,16,18,5,16,11,17,66,96,162,22,34,13.5802469135802,20.9876543209877,59.2592592592593,40.7407407407407
"323","58","5",1,1,2,1,1,21,5,13,1,2,19,17,2,15,12,27,45,98,143,28,40,19.5804195804196,27.972027972028,68.5314685314685,31.4685314685315
"324","58","6",0,0,3,0,1,11,0,13,0,3,9,13,2,10,13,55,29,107,136,55,20,40.4411764705882,14.7058823529412,78.6764705882353,21.3235294117647
"325","59","1",10,8,10,4,7,29,12,6,8,5,26,15,6,12,6,3,87,83,170,13,55,7.64705882352941,32.3529411764706,48.8235294117647,51.1764705882353
"326","59","2",2,6,9,5,9,28,4,7,5,8,29,6,4,7,7,10,72,77,149,12,57,8.05369127516779,38.255033557047,51.6778523489933,48.3221476510067
"327","59","3",1,3,10,5,9,17,9,9,4,11,16,13,6,12,9,11,66,82,148,12,33,8.10810810810811,22.2972972972973,55.4054054054054,44.5945945945946
"328","59","4",13,7,9,6,11,17,8,8,7,8,19,11,3,13,8,13,80,84,164,26,36,15.8536585365854,21.9512195121951,51.219512195122,48.780487804878
"329","59","5",4,3,9,13,10,10,10,9,3,19,11,5,12,6,8,4,68,71,139,8,21,5.75539568345324,15.1079136690647,51.0791366906475,48.9208633093525
"330","59","6",1,3,3,7,6,2,5,14,3,7,4,12,4,14,14,22,42,82,124,23,6,18.5483870967742,4.83870967741935,66.1290322580645,33.8709677419355
"331","6","1",5,8,7,11,9,23,7,15,8,9,25,11,8,14,15,8,86,100,186,13,48,6.98924731182796,25.8064516129032,53.7634408602151,46.2365591397849
"332","6","2",1,5,12,5,10,28,11,6,5,12,25,12,7,10,6,8,79,87,166,9,53,5.42168674698795,31.9277108433735,52.4096385542169,47.5903614457831
"333","6","3",2,5,18,2,16,31,7,4,5,15,29,9,4,7,4,1,87,75,162,3,60,1.85185185185185,37.037037037037,46.2962962962963,53.7037037037037
"334","6","4",20,11,9,7,8,17,9,9,11,5,15,11,9,9,9,8,92,78,170,28,32,16.4705882352941,18.8235294117647,45.8823529411765,54.1176470588235
"335","6","5",13,6,9,5,9,40,5,7,6,8,41,6,5,7,7,5,96,86,182,18,81,9.89010989010989,44.5054945054945,47.2527472527473,52.7472527472527
"336","6","6",0,3,3,8,5,10,10,12,3,9,12,14,7,15,12,27,53,100,153,27,22,17.6470588235294,14.3790849673203,65.359477124183,34.640522875817
"337","60","1",0,4,7,8,8,34,8,15,4,11,35,15,7,16,15,24,86,128,214,24,69,11.214953271028,32.2429906542056,59.8130841121495,40.1869158878505
"338","60","2",6,9,12,8,16,20,10,5,9,12,24,7,5,10,5,3,88,76,164,9,44,5.48780487804878,26.8292682926829,46.3414634146341,53.6585365853659
"339","60","3",1,2,1,5,2,14,6,14,2,4,15,16,4,17,15,25,46,100,146,26,29,17.8082191780822,19.8630136986301,68.4931506849315,31.5068493150685
"340","60","4",0,1,6,3,5,8,8,11,1,8,7,16,4,14,11,10,43,73,116,10,15,8.62068965517241,12.9310344827586,62.9310344827586,37.0689655172414
"341","60","5",0,0,3,1,1,8,4,9,0,4,5,12,3,9,9,10,27,54,81,10,13,12.3456790123457,16.0493827160494,66.6666666666667,33.3333333333333
"342","60","6",0,0,0,4,2,6,2,5,0,4,8,4,2,5,5,1,20,31,51,1,14,1.96078431372549,27.4509803921569,60.7843137254902,39.2156862745098
"343","61","1",20,13,13,9,12,26,12,3,13,9,25,6,9,5,3,2,109,74,183,22,51,12.0218579234973,27.8688524590164,40.4371584699454,59.5628415300546
"344","61","2",7,7,14,4,11,24,11,5,7,10,22,12,6,10,5,2,85,75,160,9,46,5.625,28.75,46.875,53.125
"345","61","3",18,8,10,6,9,10,11,3,9,8,9,7,8,6,3,1,78,51,129,19,19,14.7286821705426,14.7286821705426,39.5348837209302,60.4651162790698
"346","61","4",2,6,10,3,8,10,6,7,6,7,8,10,5,8,8,9,53,63,116,11,18,9.48275862068965,15.5172413793103,54.3103448275862,45.6896551724138
"347","61","5",10,4,7,6,7,7,7,2,4,9,6,3,6,3,2,4,51,39,90,14,13,15.5555555555556,14.4444444444444,43.3333333333333,56.6666666666667
"348","61","6",7,3,1,6,1,6,4,7,3,5,6,5,7,4,7,3,37,41,78,10,12,12.8205128205128,15.3846153846154,52.5641025641026,47.4358974358974
"349","62","1",2,3,12,6,17,39,7,11,3,14,44,12,1,17,11,17,99,120,219,19,83,8.67579908675799,37.8995433789954,54.7945205479452,45.2054794520548
"350","62","2",5,7,10,9,15,30,10,8,7,12,35,10,4,14,8,5,95,97,192,10,65,5.20833333333333,33.8541666666667,50.5208333333333,49.4791666666667
"351","62","3",1,3,4,2,5,8,2,13,3,3,8,13,1,13,12,68,38,124,162,69,16,42.5925925925926,9.87654320987654,76.5432098765432,23.4567901234568
"352","62","4",0,1,0,3,0,0,4,10,1,2,0,11,3,11,10,67,18,108,126,67,0,53.1746031746032,0,85.7142857142857,14.2857142857143
"353","62","5",0,0,0,2,0,1,0,6,0,2,1,4,2,5,7,45,10,68,78,45,2,57.6923076923077,2.56410256410256,87.1794871794872,12.8205128205128
"354","62","6",0,0,0,0,0,1,1,1,0,0,1,2,0,2,1,26,3,35,38,26,2,68.4210526315789,5.26315789473684,92.1052631578947,7.89473684210526
"355","63","1",7,5,7,7,8,15,10,6,6,9,16,9,7,10,6,7,68,70,138,14,31,10.1449275362319,22.463768115942,50.7246376811594,49.2753623188406
"356","63","2",10,10,12,3,7,17,9,5,10,5,12,11,7,7,5,4,74,63,137,14,29,10.2189781021898,21.1678832116788,45.985401459854,54.014598540146
"357","63","3",3,7,10,6,8,17,8,4,7,9,15,6,8,4,4,3,65,57,122,6,32,4.91803278688525,26.2295081967213,46.7213114754098,53.2786885245902
"358","63","4",2,1,1,0,0,10,1,3,1,0,8,4,1,3,3,1,19,23,42,3,18,7.14285714285714,42.8571428571429,54.7619047619048,45.2380952380952
"359","63","5",4,3,3,1,3,15,1,2,3,2,14,2,2,1,2,0,34,27,61,4,29,6.55737704918033,47.5409836065574,44.2622950819672,55.7377049180328
"360","63","6",1,2,7,3,6,16,4,3,2,8,15,4,4,3,3,1,44,41,85,2,31,2.35294117647059,36.4705882352941,48.2352941176471,51.7647058823529
"361","64","1",9,6,9,4,5,11,5,11,6,7,8,12,7,9,11,6,62,67,129,15,19,11.6279069767442,14.7286821705426,51.937984496124,48.062015503876
"362","64","2",4,5,8,10,10,11,10,4,5,13,13,4,8,6,4,0,63,55,118,4,24,3.38983050847458,20.3389830508475,46.6101694915254,53.3898305084746
"363","64","3",0,5,7,4,9,20,9,5,5,6,21,10,2,12,5,4,60,67,127,4,41,3.1496062992126,32.2834645669291,52.755905511811,47.244094488189
"364","64","4",1,4,3,7,3,7,7,7,4,6,6,7,7,7,7,28,40,74,114,29,13,25.4385964912281,11.4035087719298,64.9122807017544,35.0877192982456
"365","64","5",1,4,5,4,3,3,6,6,4,4,1,8,5,6,6,13,33,49,82,14,4,17.0731707317073,4.8780487804878,59.7560975609756,40.2439024390244
"366","64","6",1,4,4,6,3,8,4,6,4,6,6,4,7,2,5,2,36,39,75,3,14,4,18.6666666666667,52,48
"367","65","1",9,9,11,9,10,18,6,10,9,11,17,7,11,6,10,10,84,82,166,19,35,11.4457831325301,21.0843373493976,49.3975903614458,50.6024096385542
"368","65","2",10,7,10,3,11,26,6,4,7,6,27,7,2,8,4,1,79,63,142,11,53,7.74647887323944,37.3239436619718,44.3661971830986,55.6338028169014
"369","65","3",11,7,10,5,11,16,2,6,6,9,17,3,4,4,6,6,70,56,126,17,33,13.4920634920635,26.1904761904762,44.4444444444444,55.5555555555556
"370","65","4",9,7,11,3,9,5,6,3,7,6,3,6,4,4,3,9,54,44,98,18,8,18.3673469387755,8.16326530612245,44.8979591836735,55.1020408163265
"371","65","5",5,3,8,3,7,9,6,1,3,7,8,4,3,4,1,0,43,32,75,5,17,6.66666666666667,22.6666666666667,42.6666666666667,57.3333333333333
"372","65","6",0,3,3,2,1,8,5,4,3,2,5,8,4,5,4,2,27,35,62,2,13,3.2258064516129,20.9677419354839,56.4516129032258,43.5483870967742
"373","66","1",5,4,8,4,3,39,11,3,5,8,34,9,10,4,3,2,80,75,155,7,73,4.51612903225806,47.0967741935484,48.3870967741936,51.6129032258064
"374","66","2",11,6,7,6,5,11,11,3,6,7,9,8,7,6,3,4,61,52,113,15,20,13.2743362831858,17.6991150442478,46.0176991150442,53.9823008849558
"375","66","3",3,4,9,4,9,27,8,3,4,9,27,7,5,7,4,4,69,68,137,7,54,5.10948905109489,39.4160583941606,49.6350364963504,50.3649635036496
"376","66","4",5,7,7,8,12,18,9,5,7,8,23,6,3,11,5,4,73,68,141,9,41,6.38297872340426,29.0780141843972,48.2269503546099,51.7730496453901
"377","66","5",21,10,14,4,13,12,6,2,9,8,12,4,4,4,2,1,84,45,129,22,24,17.0542635658915,18.6046511627907,34.8837209302326,65.1162790697674
"378","66","6",6,5,8,7,5,41,10,5,5,10,39,8,10,5,5,4,89,87,176,10,80,5.68181818181818,45.4545454545455,49.4318181818182,50.5681818181818
"379","67","1",8,8,11,5,13,20,9,4,8,8,22,8,4,9,4,1,80,65,145,9,42,6.20689655172414,28.9655172413793,44.8275862068966,55.1724137931034
"380","67","2",6,6,10,3,10,37,6,2,6,7,38,5,3,6,2,3,82,71,153,9,75,5.88235294117647,49.0196078431373,46.4052287581699,53.5947712418301
"381","67","3",12,10,8,7,10,20,7,6,9,5,22,6,4,8,6,5,81,67,148,17,42,11.4864864864865,28.3783783783784,45.2702702702703,54.7297297297297
"382","67","4",1,1,3,3,3,12,5,10,1,5,12,11,3,11,10,32,39,87,126,33,24,26.1904761904762,19.047619047619,69.0476190476191,30.952380952381
"383","67","5",0,2,3,7,5,2,4,10,2,8,4,7,6,8,10,22,35,68,103,22,6,21.3592233009709,5.8252427184466,66.0194174757282,33.9805825242718
"384","67","6",2,2,3,2,1,3,0,6,2,3,1,4,3,2,5,33,19,56,75,35,4,46.6666666666667,5.33333333333333,74.6666666666667,25.3333333333333
"385","68","1",6,4,5,2,5,31,5,1,4,3,32,4,1,5,1,1,61,52,113,7,63,6.19469026548673,55.7522123893805,46.0176991150442,53.9823008849558
"386","68","2",2,3,7,3,5,18,9,9,3,7,16,15,6,12,9,10,58,79,137,12,34,8.75912408759124,24.8175182481752,57.6642335766423,42.3357664233577
"387","68","3",3,6,8,3,6,12,9,2,6,5,10,8,5,6,2,0,52,42,94,3,22,3.19148936170213,23.4042553191489,44.6808510638298,55.3191489361702
"388","68","4",0,0,4,0,4,16,3,4,0,4,17,7,0,7,4,4,33,44,77,4,33,5.19480519480519,42.8571428571429,57.1428571428571,42.8571428571429
"389","68","5",0,0,3,2,5,23,3,0,0,5,24,1,0,3,0,0,37,35,72,0,47,0,65.2777777777778,48.6111111111111,51.3888888888889
"390","68","6",1,3,6,2,6,25,4,1,2,5,26,3,1,4,1,3,50,46,96,4,51,4.16666666666667,53.125,47.9166666666667,52.0833333333333
"391","69","1",1,2,3,4,4,16,6,9,2,5,17,11,2,13,9,6,46,67,113,7,33,6.19469026548673,29.2035398230088,59.2920353982301,40.7079646017699
"392","69","2",0,1,5,1,4,14,8,10,1,5,13,16,2,16,10,13,44,78,122,13,27,10.655737704918,22.1311475409836,63.9344262295082,36.0655737704918
"393","69","3",0,0,4,0,4,23,9,2,0,4,24,10,0,11,2,1,44,53,97,1,47,1.03092783505155,48.4536082474227,54.639175257732,45.360824742268
"394","69","4",0,0,2,3,2,37,5,2,0,5,37,4,3,4,2,1,52,58,110,1,74,0.909090909090909,67.2727272727273,52.7272727272727,47.2727272727273
"395","69","5",1,1,7,1,7,29,7,0,1,7,29,6,2,5,0,0,55,51,106,1,58,0.943396226415094,54.7169811320755,48.1132075471698,51.8867924528302
"396","69","6",2,5,9,1,8,15,3,2,5,5,15,3,2,3,2,2,47,38,85,4,30,4.70588235294118,35.2941176470588,44.7058823529412,55.2941176470588
"397","7","1",9,14,16,10,14,15,17,9,14,12,13,17,12,15,10,5,105,100,205,14,28,6.82926829268293,13.6585365853659,48.780487804878,51.219512195122
"398","7","2",10,9,9,15,11,12,17,8,10,15,14,10,14,12,8,7,94,90,184,17,26,9.23913043478261,14.1304347826087,48.9130434782609,51.0869565217391
"399","7","3",7,13,12,12,12,12,14,8,13,11,11,10,12,9,7,1,90,77,167,8,23,4.79041916167665,13.7724550898204,46.1077844311377,53.8922155688623
"400","7","4",11,15,17,6,18,18,6,6,15,8,18,6,5,7,6,5,98,72,170,16,36,9.41176470588235,21.1764705882353,42.3529411764706,57.6470588235294
"401","7","5",16,10,10,7,10,8,6,5,10,8,8,3,8,3,5,12,74,58,132,28,16,21.2121212121212,12.1212121212121,43.9393939393939,56.0606060606061
"402","7","6",9,5,8,2,9,16,6,4,4,6,17,8,1,9,4,5,61,55,116,14,33,12.0689655172414,28.448275862069,47.4137931034483,52.5862068965517
"403","70","1",5,5,5,5,8,20,5,6,5,5,23,6,2,8,5,5,59,62,121,10,43,8.26446280991735,35.5371900826446,51.2396694214876,48.7603305785124
"404","70","2",4,6,7,2,5,15,4,6,6,3,13,9,4,7,6,9,50,59,109,13,28,11.9266055045872,25.6880733944954,54.1284403669725,45.8715596330275
"405","70","3",1,4,5,7,8,17,10,4,4,8,20,8,4,10,4,1,57,61,118,2,37,1.69491525423729,31.3559322033898,51.6949152542373,48.3050847457627
"406","70","4",0,1,4,3,3,20,12,9,0,6,19,18,4,17,9,6,54,80,134,6,39,4.47761194029851,29.1044776119403,59.7014925373134,40.2985074626866
"407","70","5",0,0,2,6,1,11,7,12,0,8,10,13,7,11,11,18,39,81,120,18,21,15,17.5,67.5,32.5
"408","70","6",3,4,4,4,5,6,2,9,4,4,7,8,3,8,9,26,38,71,109,29,13,26.605504587156,11.9266055045872,65.1376146788991,34.8623853211009
"409","71","1",3,9,12,9,10,25,12,6,8,12,23,9,10,8,6,2,87,80,167,5,48,2.9940119760479,28.7425149700599,47.9041916167665,52.0958083832335
"410","71","2",7,10,11,10,9,23,8,12,9,11,21,10,11,8,12,19,91,103,194,26,44,13.4020618556701,22.680412371134,53.0927835051546,46.9072164948454
"411","71","3",9,10,12,7,12,14,6,9,10,9,14,8,7,8,9,9,79,77,156,18,28,11.5384615384615,17.9487179487179,49.3589743589744,50.6410256410256
"412","71","4",6,7,8,8,10,14,7,12,6,9,16,11,5,13,12,17,73,91,164,23,30,14.0243902439024,18.2926829268293,55.4878048780488,44.5121951219512
"413","71","5",2,4,6,7,5,17,10,11,4,10,16,14,9,13,12,20,64,99,163,22,33,13.4969325153374,20.2453987730061,60.7361963190184,39.2638036809816
"414","71","6",2,4,10,5,10,16,8,12,5,11,16,15,6,15,13,13,70,94,164,15,32,9.14634146341463,19.5121951219512,57.3170731707317,42.6829268292683
"415","72","1",2,4,12,4,10,38,9,6,4,12,37,10,6,9,6,3,87,88,175,5,75,2.85714285714286,42.8571428571429,50.2857142857143,49.7142857142857
"416","72","2",1,1,5,6,6,14,9,11,1,10,15,15,5,15,11,20,54,94,148,21,29,14.1891891891892,19.5945945945946,63.5135135135135,36.4864864864865
"417","72","3",0,0,1,4,3,24,4,19,0,5,26,20,2,22,19,54,56,150,206,54,50,26.2135922330097,24.2718446601942,72.8155339805825,27.1844660194175
"418","72","4",0,0,3,5,6,26,5,5,0,9,29,4,3,7,5,10,52,68,120,10,55,8.33333333333333,45.8333333333333,56.6666666666667,43.3333333333333
"419","72","5",0,0,4,4,6,35,8,4,0,8,38,8,2,10,4,7,63,78,141,7,73,4.9645390070922,51.7730496453901,55.3191489361702,44.6808510638298
"420","72","6",0,0,0,5,4,20,5,9,0,5,24,9,1,13,9,12,44,75,119,12,44,10.0840336134454,36.9747899159664,63.0252100840336,36.9747899159664
"421","73","1",2,5,4,7,6,18,7,13,5,6,19,13,5,14,13,10,63,87,150,12,37,8,24.6666666666667,58,42
"422","73","2",1,1,0,6,3,7,5,12,1,5,10,11,3,14,12,21,36,79,115,22,17,19.1304347826087,14.7826086956522,68.695652173913,31.304347826087
"423","73","3",5,5,5,4,5,9,8,6,5,4,9,11,4,11,6,10,48,62,110,15,18,13.6363636363636,16.3636363636364,56.3636363636364,43.6363636363636
"424","73","4",2,3,6,3,5,8,9,6,3,6,7,11,4,10,6,6,43,55,98,8,15,8.16326530612245,15.3061224489796,56.1224489795918,43.8775510204082
"425","73","5",1,1,3,4,4,10,9,4,1,6,11,9,3,10,4,6,37,52,89,7,21,7.86516853932584,23.5955056179775,58.4269662921348,41.5730337078652
"426","73","6",4,0,0,4,3,12,5,5,1,4,15,6,2,8,5,4,36,45,81,8,27,9.87654320987654,33.3333333333333,55.5555555555556,44.4444444444444
"427","74","1",9,7,2,9,2,6,8,5,7,4,6,5,9,5,5,1,49,44,93,10,12,10.752688172043,12.9032258064516,47.3118279569892,52.6881720430108
"428","74","2",13,5,4,8,5,12,6,8,4,7,13,6,6,8,8,12,62,66,128,25,25,19.53125,19.53125,51.5625,48.4375
"429","74","3",4,2,1,6,4,36,8,4,2,4,40,6,2,10,4,3,67,72,139,7,76,5.03597122302158,54.6762589928058,51.7985611510791,48.2014388489209
"430","74","4",1,1,2,5,5,28,3,5,1,6,31,3,2,5,4,2,50,57,107,3,59,2.80373831775701,55.1401869158879,53.2710280373832,46.7289719626168
"431","74","5",0,0,3,3,3,13,5,8,0,6,13,10,3,10,9,12,36,65,101,12,26,11.8811881188119,25.7425742574257,64.3564356435644,35.6435643564356
"432","74","6",0,0,3,7,3,12,7,3,0,10,13,2,7,3,3,0,37,39,76,0,25,0,32.8947368421053,51.3157894736842,48.6842105263158
"433","75","1",12,9,11,6,9,25,11,5,9,8,24,9,8,8,5,4,90,76,166,16,49,9.63855421686747,29.5180722891566,45.7831325301205,54.2168674698795
"434","75","2",1,4,12,2,11,44,5,3,4,10,43,6,2,6,3,0,83,76,159,1,87,0.628930817610063,54.7169811320755,47.7987421383648,52.2012578616352
"435","75","3",1,5,8,2,10,62,6,0,5,5,63,4,1,5,0,0,96,84,180,1,125,0.555555555555556,69.4444444444444,46.6666666666667,53.3333333333333
"436","75","4",1,3,12,2,14,55,3,0,3,11,57,0,0,3,0,0,91,76,167,1,112,0.598802395209581,67.065868263473,45.5089820359281,54.4910179640719
"437","75","5",1,1,7,0,5,53,2,0,1,5,51,2,1,1,0,0,70,63,133,1,104,0.75187969924812,78.1954887218045,47.3684210526316,52.6315789473684
"438","75","6",12,5,7,3,6,26,12,4,5,5,25,12,4,11,3,7,75,75,150,19,51,12.6666666666667,34,50,50
"439","76","1",39,10,8,5,9,13,6,3,10,2,14,4,4,5,3,2,95,45,140,41,27,29.2857142857143,19.2857142857143,32.1428571428571,67.8571428571429
"440","76","2",1,5,3,5,5,26,12,9,5,3,28,16,3,19,9,6,67,91,158,7,54,4.43037974683544,34.1772151898734,57.5949367088608,42.4050632911392
"441","76","3",2,1,1,1,1,11,12,6,1,1,12,16,1,17,6,7,37,62,99,9,23,9.09090909090909,23.2323232323232,62.6262626262626,37.3737373737374
"442","76","4",0,0,0,0,0,21,1,1,0,0,21,2,0,2,1,1,25,28,53,1,42,1.88679245283019,79.2452830188679,52.8301886792453,47.1698113207547
"443","76","5",0,0,3,3,3,14,7,8,0,6,15,12,3,12,8,13,40,70,110,13,29,11.8181818181818,26.3636363636364,63.6363636363636,36.3636363636364
"444","76","6",0,0,5,6,6,15,10,7,0,11,17,11,5,12,7,6,51,70,121,6,32,4.95867768595041,26.4462809917355,57.8512396694215,42.1487603305785
"445","77","1",9,9,8,5,9,12,2,6,9,3,13,3,3,5,6,6,61,50,111,15,25,13.5135135135135,22.5225225225225,45.045045045045,54.954954954955
"446","77","2",8,8,7,3,7,16,4,6,7,2,16,7,2,7,5,9,59,58,117,17,32,14.5299145299145,27.3504273504273,49.5726495726496,50.4273504273504
"447","77","3",8,11,7,7,6,6,8,10,11,3,5,11,8,10,10,19,64,79,143,27,11,18.8811188811189,7.69230769230769,55.2447552447552,44.7552447552448
"448","77","4",74,18,18,5,20,4,6,0,19,5,6,1,4,3,1,0,148,39,187,74,10,39.572192513369,5.3475935828877,20.855614973262,79.144385026738
"449","77","5",140,9,8,1,8,0,1,0,8,0,0,0,1,0,0,0,169,10,179,140,0,78.2122905027933,0,5.58659217877095,94.413407821229
"450","77","6",129,4,4,0,4,1,0,0,4,0,1,0,0,0,0,0,145,5,150,129,2,86,1.33333333333333,3.33333333333333,96.6666666666667
"451","78","1",0,2,1,5,4,15,10,9,2,4,18,14,2,18,10,11,47,81,128,11,33,8.59375,25.78125,63.28125,36.71875
"452","78","2",20,4,6,4,7,4,1,4,5,6,5,1,4,2,4,6,53,33,86,26,9,30.2325581395349,10.4651162790698,38.3720930232558,61.6279069767442
"453","78","3",1,4,5,5,8,7,3,5,4,6,10,3,2,5,4,5,38,42,80,6,17,7.5,21.25,52.5,47.5
"454","78","4",5,1,2,2,2,7,4,1,1,3,7,3,2,4,2,1,25,25,50,6,14,12,28,50,50
"455","78","5",2,0,2,1,2,6,1,3,1,3,6,3,2,2,3,5,20,25,45,7,12,15.5555555555556,26.6666666666667,55.5555555555556,44.4444444444444
"456","78","6",0,0,2,2,1,9,4,2,0,3,8,4,2,4,2,3,21,28,49,3,17,6.12244897959184,34.6938775510204,57.1428571428571,42.8571428571429
"457","79","1",2,4,14,0,10,49,7,3,3,10,46,10,3,7,3,3,91,86,177,5,95,2.82485875706215,53.6723163841808,48.5875706214689,51.4124293785311
"458","79","2",2,5,5,5,7,15,4,12,5,5,17,12,3,13,12,35,56,104,160,37,32,23.125,20,65,35
"459","79","3",0,0,3,1,2,47,4,3,0,4,46,7,2,5,3,0,61,69,130,0,93,0,71.5384615384615,53.0769230769231,46.9230769230769
"460","79","4",0,0,3,3,5,11,1,17,0,6,13,15,2,16,17,39,42,109,151,39,24,25.8278145695364,15.8940397350993,72.1854304635762,27.8145695364238
"461","79","5",0,0,2,1,2,24,5,7,0,3,23,12,1,11,7,21,42,80,122,21,47,17.2131147540984,38.5245901639344,65.5737704918033,34.4262295081967
"462","79","6",1,1,2,0,2,34,3,4,2,1,33,7,1,6,4,5,50,59,109,6,67,5.5045871559633,61.4678899082569,54.1284403669725,45.8715596330275
"463","8","1",2,4,9,7,10,11,11,9,4,12,13,12,6,14,9,13,65,84,149,15,24,10.0671140939597,16.1073825503356,56.3758389261745,43.6241610738255
"464","8","2",0,3,8,6,7,32,8,4,3,11,31,6,7,5,4,6,70,74,144,6,63,4.16666666666667,43.75,51.3888888888889,48.6111111111111
"465","8","3",5,5,11,5,8,24,13,6,5,11,22,14,8,11,6,4,79,82,161,9,46,5.59006211180124,28.5714285714286,50.9316770186335,49.0683229813665
"466","8","4",13,10,7,6,9,10,8,6,10,3,13,8,4,11,7,14,71,71,142,27,23,19.0140845070423,16.1971830985915,50,50
"467","8","5",11,8,4,7,7,4,6,9,8,3,7,8,4,11,9,3,57,55,112,14,11,12.5,9.82142857142857,49.1071428571429,50.8928571428571
"468","8","6",5,4,4,4,4,16,5,6,4,4,15,7,4,6,6,9,49,57,106,14,31,13.2075471698113,29.2452830188679,53.7735849056604,46.2264150943396
"469","80","1",12,10,12,4,11,34,9,3,10,6,33,8,5,7,3,1,97,74,171,13,67,7.60233918128655,39.1812865497076,43.2748538011696,56.7251461988304
"470","80","2",3,6,14,2,11,20,6,6,6,11,17,10,5,7,6,9,70,72,142,12,37,8.45070422535211,26.056338028169,50.7042253521127,49.2957746478873
"471","80","3",4,3,5,1,5,38,4,4,4,3,37,7,2,6,4,6,67,69,136,10,75,7.35294117647059,55.1470588235294,50.7352941176471,49.2647058823529
"472","80","4",22,9,13,3,13,7,5,4,9,7,7,5,3,5,4,14,77,56,133,36,14,27.0676691729323,10.5263157894737,42.1052631578947,57.8947368421053
"473","80","5",15,12,10,7,15,14,5,6,12,6,19,4,3,9,6,7,86,67,153,22,33,14.3790849673203,21.5686274509804,43.7908496732026,56.2091503267974
"474","80","6",3,4,4,6,4,14,9,9,4,6,15,11,6,12,9,12,55,76,131,15,29,11.4503816793893,22.1374045801527,58.0152671755725,41.9847328244275
"475","81","1",11,7,10,9,8,18,9,6,7,12,17,6,11,4,6,7,80,71,151,18,35,11.9205298013245,23.1788079470199,47.0198675496689,52.9801324503311
"476","81","2",8,9,15,4,14,21,3,5,9,10,20,4,5,3,5,5,80,63,143,13,41,9.09090909090909,28.6713286713287,44.0559440559441,55.9440559440559
"477","81","3",10,6,9,7,11,16,9,4,6,10,17,6,6,7,4,3,74,60,134,13,33,9.70149253731343,24.6268656716418,44.7761194029851,55.2238805970149
"478","81","4",13,8,4,7,6,4,8,5,7,3,6,6,4,8,4,1,55,42,97,14,10,14.4329896907216,10.3092783505155,43.298969072165,56.701030927835
"479","81","5",5,7,6,3,7,5,4,2,7,1,6,3,1,4,2,1,40,27,67,6,11,8.95522388059701,16.4179104477612,40.2985074626866,59.7014925373134
"480","81","6",0,0,2,3,4,10,6,3,0,5,12,7,1,8,3,2,29,40,69,2,22,2.89855072463768,31.8840579710145,57.9710144927536,42.0289855072464
"481","82","1",14,8,12,8,14,12,8,4,8,11,14,4,5,7,4,5,81,60,141,19,26,13.4751773049645,18.4397163120567,42.5531914893617,57.4468085106383
"482","82","2",9,6,9,3,7,22,10,0,6,5,21,7,4,6,0,0,68,50,118,9,43,7.6271186440678,36.4406779661017,42.3728813559322,57.6271186440678
"483","82","3",3,3,9,4,7,15,9,0,3,10,13,4,6,3,0,0,51,41,92,3,28,3.26086956521739,30.4347826086957,44.5652173913044,55.4347826086956
"484","82","4",6,4,6,2,7,9,4,3,4,4,11,4,1,6,3,6,43,40,83,12,20,14.4578313253012,24.0963855421687,48.1927710843374,51.8072289156626
"485","82","5",1,2,3,2,5,15,5,2,2,3,17,6,0,8,2,0,36,40,76,1,32,1.31578947368421,42.1052631578947,52.6315789473684,47.3684210526316
"486","82","6",3,1,7,1,5,8,5,0,2,7,6,4,4,1,0,0,33,24,57,3,14,5.26315789473684,24.5614035087719,42.1052631578947,57.8947368421053
"487","83","1",2,1,6,4,5,26,10,2,0,9,25,8,4,7,2,1,57,58,115,3,51,2.60869565217391,44.3478260869565,50.4347826086956,49.5652173913044
"488","83","2",1,1,5,2,5,30,5,0,1,6,31,3,2,3,0,0,51,47,98,1,61,1.02040816326531,62.2448979591837,47.9591836734694,52.0408163265306
"489","83","3",0,0,3,2,4,29,5,1,0,5,30,4,1,4,0,1,44,48,92,1,59,1.08695652173913,64.1304347826087,52.1739130434783,47.8260869565217
"490","83","4",1,0,2,1,2,26,3,0,1,3,26,2,2,1,0,0,38,35,73,1,52,1.36986301369863,71.2328767123288,47.9452054794521,52.0547945205479
"491","83","5",5,1,3,1,3,12,4,0,1,3,12,3,0,4,0,0,30,25,55,5,24,9.09090909090909,43.6363636363636,45.4545454545455,54.5454545454545
"492","83","6",4,2,3,3,2,16,6,1,2,3,15,4,3,3,0,1,37,34,71,5,31,7.04225352112676,43.6619718309859,47.887323943662,52.112676056338
"493","84","1",7,7,6,5,8,9,2,4,7,5,10,1,4,2,4,3,50,37,87,10,19,11.4942528735632,21.8390804597701,42.5287356321839,57.4712643678161
"494","84","2",2,2,7,3,7,18,4,4,2,8,18,5,2,5,4,3,48,49,97,5,36,5.15463917525773,37.1134020618557,50.5154639175258,49.4845360824742
"495","84","3",1,1,6,1,6,13,6,1,1,7,13,6,2,5,1,1,37,37,74,2,26,2.7027027027027,35.1351351351351,50,50
"496","84","4",2,1,1,2,2,20,5,2,1,2,20,5,1,6,2,1,36,40,76,3,40,3.94736842105263,52.6315789473684,52.6315789473684,47.3684210526316
"497","84","5",0,0,0,3,2,22,3,1,0,3,24,1,1,3,1,1,33,35,68,1,46,1.47058823529412,67.6470588235294,51.4705882352941,48.5294117647059
"498","84","6",0,1,2,2,2,11,4,1,1,3,12,3,1,4,1,2,25,28,53,2,23,3.77358490566038,43.3962264150943,52.8301886792453,47.1698113207547
"499","85","1",4,10,13,7,11,24,10,8,9,10,22,11,8,9,8,3,88,82,170,7,46,4.11764705882353,27.0588235294118,48.2352941176471,51.7647058823529
"500","85","2",1,3,4,7,3,20,7,13,3,8,19,13,8,12,13,10,60,87,147,11,39,7.48299319727891,26.530612244898,59.1836734693878,40.8163265306122
"501","85","3",1,4,8,2,8,17,6,6,4,6,16,10,2,9,6,4,53,59,112,5,33,4.46428571428571,29.4642857142857,52.6785714285714,47.3214285714286
"502","85","4",0,1,3,3,5,14,6,8,1,5,16,11,1,12,7,34,40,90,130,34,30,26.1538461538462,23.0769230769231,69.2307692307692,30.7692307692308
"503","85","5",1,1,3,4,3,13,8,9,1,6,13,13,4,14,10,15,43,78,121,16,26,13.2231404958678,21.4876033057851,64.4628099173554,35.5371900826446
"504","85","6",1,4,0,6,2,1,7,6,4,1,3,7,3,9,5,44,27,79,106,45,4,42.4528301886792,3.77358490566038,74.5283018867924,25.4716981132075
"505","86","1",9,10,16,10,18,32,14,6,10,16,33,10,9,11,6,5,117,101,218,14,65,6.42201834862385,29.8165137614679,46.3302752293578,53.6697247706422
"506","86","2",22,13,16,9,15,9,11,4,14,12,8,6,11,5,5,1,102,62,164,23,17,14.0243902439024,10.3658536585366,37.8048780487805,62.1951219512195
"507","86","3",7,7,9,6,8,11,10,5,7,8,10,8,7,7,5,3,64,57,121,10,21,8.26446280991735,17.3553719008264,47.1074380165289,52.8925619834711
"508","86","4",8,5,7,2,3,12,5,4,5,4,7,7,6,3,4,6,47,44,91,14,19,15.3846153846154,20.8791208791209,48.3516483516484,51.6483516483516
"509","86","5",2,4,6,3,8,11,4,2,4,5,12,3,1,4,2,0,41,33,74,2,23,2.7027027027027,31.0810810810811,44.5945945945946,55.4054054054054
"510","86","6",3,4,10,2,6,34,9,0,4,8,31,7,5,4,0,0,70,60,130,3,65,2.30769230769231,50,46.1538461538462,53.8461538461538
"511","87","1",2,7,7,7,5,20,9,9,7,7,18,10,9,8,8,3,66,73,139,5,38,3.59712230215827,27.3381294964029,52.5179856115108,47.4820143884892
"512","87","2",15,14,16,7,15,12,11,5,14,9,11,9,8,8,5,5,97,70,167,20,23,11.9760479041916,13.7724550898204,41.9161676646707,58.0838323353293
"513","87","3",9,9,14,8,14,17,12,7,10,13,17,11,9,11,7,1,93,79,172,10,34,5.81395348837209,19.7674418604651,45.9302325581395,54.0697674418605
"514","87","4",7,12,10,10,11,12,11,10,12,7,13,11,9,12,10,5,85,80,165,12,25,7.27272727272727,15.1515151515152,48.4848484848485,51.5151515151515
"515","87","5",1,13,19,4,21,19,4,1,13,10,21,1,2,3,1,0,84,52,136,1,40,0.735294117647059,29.4117647058824,38.2352941176471,61.7647058823529
"516","87","6",10,8,12,6,11,12,10,1,9,10,11,5,7,4,1,0,73,47,120,10,23,8.33333333333333,19.1666666666667,39.1666666666667,60.8333333333333
"517","88","1",6,3,6,6,6,22,12,4,3,10,22,10,7,9,4,2,67,68,135,8,44,5.92592592592593,32.5925925925926,50.3703703703704,49.6296296296296
"518","88","2",7,4,5,3,7,54,5,0,4,4,56,1,1,4,0,0,86,72,158,7,110,4.43037974683544,69.620253164557,45.5696202531646,54.4303797468354
"519","88","3",0,0,3,0,2,43,2,0,0,3,41,2,1,1,0,0,51,50,101,0,84,0,83.1683168316832,49.5049504950495,50.4950495049505
"520","88","4",3,2,5,5,4,25,8,2,1,8,25,5,5,5,2,0,56,52,108,3,50,2.77777777777778,46.2962962962963,48.1481481481481,51.8518518518519
"521","88","5",4,1,7,1,7,28,7,1,1,7,28,7,2,6,1,2,58,55,113,6,56,5.30973451327434,49.5575221238938,48.6725663716814,51.3274336283186
"522","88","6",0,2,5,5,5,35,13,2,2,8,36,10,5,10,2,6,69,80,149,6,71,4.02684563758389,47.6510067114094,53.6912751677852,46.3087248322148
"523","89","1",2,3,6,11,7,30,14,12,3,14,31,15,9,16,11,10,85,112,197,12,61,6.09137055837563,30.9644670050761,56.8527918781726,43.1472081218274
"524","89","2",12,11,8,9,12,11,9,6,11,6,15,6,5,10,6,9,81,68,149,21,26,14.0939597315436,17.4496644295302,45.6375838926174,54.3624161073826
"525","89","3",9,5,8,5,8,3,8,2,5,8,3,6,5,5,2,1,49,37,86,10,6,11.6279069767442,6.97674418604651,43.0232558139535,56.9767441860465
"526","89","4",28,3,6,1,4,6,2,1,4,4,4,2,3,0,1,0,54,18,72,28,10,38.8888888888889,13.8888888888889,25,75
"527","89","5",12,3,2,4,5,1,5,2,3,3,3,3,1,6,2,2,35,25,60,14,4,23.3333333333333,6.66666666666667,41.6666666666667,58.3333333333333
"528","89","6",9,5,3,4,2,2,4,5,5,2,1,4,5,3,5,1,35,28,63,10,3,15.8730158730159,4.76190476190476,44.4444444444444,55.5555555555556
"529","9","1",7,9,12,6,10,36,8,9,9,9,34,11,8,9,10,6,98,98,196,13,70,6.63265306122449,35.7142857142857,50,50
"530","9","2",2,6,15,8,15,18,11,9,6,17,18,11,8,11,8,3,84,85,169,5,36,2.9585798816568,21.301775147929,50.2958579881657,49.7041420118343
"531","9","3",9,12,15,9,13,9,6,9,12,12,7,6,11,4,9,9,84,71,155,18,16,11.6129032258065,10.3225806451613,45.8064516129032,54.1935483870968
"532","9","4",8,12,12,12,16,10,7,10,12,12,14,5,8,9,9,13,87,85,172,21,24,12.2093023255814,13.953488372093,49.4186046511628,50.5813953488372
"533","9","5",17,11,13,5,13,13,3,5,11,7,14,3,5,3,5,0,82,49,131,17,27,12.9770992366412,20.6106870229008,37.4045801526718,62.5954198473282
"534","9","6",1,2,5,7,5,19,10,5,2,10,19,8,7,7,5,6,55,66,121,7,38,5.78512396694215,31.404958677686,54.5454545454545,45.4545454545455
"535","90","1",2,9,13,7,15,32,13,10,9,11,33,16,5,17,10,12,102,115,217,14,65,6.45161290322581,29.9539170506912,52.9953917050691,47.0046082949309
"536","90","2",17,17,20,15,22,15,12,7,17,17,17,4,13,6,7,4,127,86,213,21,32,9.85915492957746,15.0234741784038,40.3755868544601,59.6244131455399
"537","90","3",28,12,16,7,16,8,7,8,12,11,8,8,7,8,8,4,105,66,171,32,16,18.7134502923977,9.35672514619883,38.5964912280702,61.4035087719298
"538","90","4",6,6,15,7,14,18,9,5,6,16,16,8,8,6,5,2,81,69,150,8,34,5.33333333333333,22.6666666666667,46,54
"539","90","5",1,7,15,3,16,25,7,1,7,11,26,5,2,6,1,2,76,62,138,3,51,2.17391304347826,36.9565217391304,44.9275362318841,55.0724637681159
"540","90","6",9,9,9,7,10,22,10,2,8,7,24,5,5,7,2,1,80,60,140,10,46,7.14285714285714,32.8571428571429,42.8571428571429,57.1428571428571
"541","91","1",22,10,8,7,6,7,11,1,10,5,5,5,9,3,1,0,73,40,113,22,12,19.4690265486726,10.6194690265487,35.3982300884956,64.6017699115044
"542","91","2",3,7,8,10,8,15,15,5,7,11,15,10,11,10,5,8,73,78,151,11,30,7.28476821192053,19.8675496688742,51.6556291390729,48.3443708609271
"543","91","3",7,4,8,13,10,15,8,10,4,16,17,6,10,8,10,9,76,82,158,16,32,10.126582278481,20.253164556962,51.8987341772152,48.1012658227848
"544","91","4",20,11,11,5,13,13,4,2,11,5,15,1,3,3,2,1,82,41,123,21,28,17.0731707317073,22.7642276422764,33.3333333333333,66.6666666666667
"545","91","5",16,13,11,7,11,8,8,4,13,6,8,5,8,4,4,0,80,49,129,16,16,12.4031007751938,12.4031007751938,37.984496124031,62.015503875969
"546","91","6",31,8,12,12,14,8,13,6,9,16,10,7,10,9,6,3,107,70,177,34,18,19.2090395480226,10.1694915254237,39.5480225988701,60.4519774011299
"547","92","1",50,18,17,11,18,11,9,9,18,11,12,7,10,8,9,12,145,88,233,62,23,26.6094420600858,9.87124463519313,37.7682403433476,62.2317596566524
"548","92","2",23,21,26,6,27,12,8,5,21,11,13,7,5,8,5,4,128,77,205,27,25,13.1707317073171,12.1951219512195,37.5609756097561,62.4390243902439
"549","92","3",11,14,17,8,16,9,12,4,14,12,8,8,10,7,5,4,93,69,162,15,17,9.25925925925926,10.4938271604938,42.5925925925926,57.4074074074074
"550","92","4",3,2,8,6,7,29,15,4,2,12,28,12,7,12,4,2,75,81,156,5,57,3.20512820512821,36.5384615384615,51.9230769230769,48.0769230769231
"551","92","5",5,3,6,10,6,17,13,6,3,13,17,10,10,9,6,16,67,86,153,21,34,13.7254901960784,22.2222222222222,56.2091503267974,43.7908496732026
"552","92","6",1,1,11,6,5,22,14,4,1,16,16,12,12,6,4,9,66,77,143,10,38,6.99300699300699,26.5734265734266,53.8461538461538,46.1538461538462
"553","93","1",3,3,6,10,12,23,12,9,3,13,29,10,4,16,8,10,78,96,174,13,52,7.47126436781609,29.8850574712644,55.1724137931034,44.8275862068966
"554","93","2",5,6,5,8,8,19,8,9,6,7,22,9,5,11,8,19,68,90,158,24,41,15.1898734177215,25.9493670886076,56.9620253164557,43.0379746835443
"555","93","3",8,6,10,6,9,36,10,7,6,10,35,11,7,10,7,8,94,95,189,16,71,8.46560846560847,37.5661375661376,50.2645502645503,49.7354497354497
"556","93","4",18,13,14,11,12,21,15,5,13,12,20,9,12,8,5,0,111,80,191,18,41,9.42408376963351,21.4659685863874,41.8848167539267,58.1151832460733
"557","93","5",13,15,17,10,17,16,12,5,15,12,16,7,10,7,5,0,107,73,180,13,32,7.22222222222222,17.7777777777778,40.5555555555556,59.4444444444444
"558","93","6",13,11,16,4,15,24,4,3,11,9,24,3,5,2,3,0,92,58,150,13,48,8.66666666666667,32,38.6666666666667,61.3333333333333
"559","94","1",3,5,10,9,10,33,9,12,5,14,33,12,10,11,12,25,93,123,216,28,66,12.962962962963,30.5555555555556,56.9444444444444,43.0555555555556
"560","94","2",6,5,6,10,7,18,10,11,5,11,19,12,9,13,11,31,74,113,187,37,37,19.7860962566845,19.7860962566845,60.427807486631,39.572192513369
"561","94","3",5,7,4,14,11,14,14,9,7,11,21,8,7,15,8,9,78,89,167,14,35,8.38323353293413,20.9580838323353,53.2934131736527,46.7065868263473
"562","94","4",0,2,4,7,6,16,12,7,2,9,19,12,5,15,8,20,56,91,147,20,35,13.6054421768707,23.8095238095238,61.9047619047619,38.0952380952381
"563","94","5",0,0,0,1,1,20,2,8,0,1,21,9,0,11,9,17,33,70,103,17,41,16.504854368932,39.8058252427184,67.9611650485437,32.0388349514563
"564","94","6",0,0,2,2,3,8,3,3,0,4,8,5,1,5,3,6,22,34,56,6,16,10.7142857142857,28.5714285714286,60.7142857142857,39.2857142857143
"565","95","1",10,9,14,8,14,14,8,6,9,12,14,6,7,7,6,3,84,66,150,13,28,8.66666666666667,18.6666666666667,44,56
"566","95","2",3,8,10,7,11,25,7,8,8,9,27,8,6,10,8,7,81,84,165,10,52,6.06060606060606,31.5151515151515,50.9090909090909,49.0909090909091
"567","95","3",6,10,15,6,11,14,14,4,10,12,10,12,11,7,4,3,82,70,152,9,24,5.92105263157895,15.7894736842105,46.0526315789474,53.9473684210526
"568","95","4",5,6,10,4,11,21,12,1,6,8,22,9,4,9,1,0,72,60,132,5,43,3.78787878787879,32.5757575757576,45.4545454545455,54.5454545454545
"569","95","5",2,2,10,6,11,14,8,4,2,14,16,6,5,7,4,0,59,55,114,2,30,1.75438596491228,26.3157894736842,48.2456140350877,51.7543859649123
"570","95","6",14,8,7,6,10,6,4,2,8,5,9,0,3,3,2,2,58,34,92,16,15,17.3913043478261,16.304347826087,36.9565217391304,63.0434782608696
"571","96","1",10,6,11,10,15,33,8,8,6,15,37,7,6,11,8,17,102,109,211,27,70,12.7962085308057,33.175355450237,51.6587677725119,48.3412322274881
"572","96","2",17,10,11,7,10,33,6,8,10,8,32,7,7,7,8,5,103,86,189,22,65,11.6402116402116,34.3915343915344,45.5026455026455,54.4973544973545
"573","96","3",3,2,5,2,5,38,6,7,2,5,37,11,2,11,7,6,69,83,152,9,75,5.92105263157895,49.3421052631579,54.6052631578947,45.3947368421053
"574","96","4",2,3,7,1,4,46,5,2,3,5,44,6,4,4,2,1,72,70,142,3,90,2.11267605633803,63.3802816901408,49.2957746478873,50.7042253521127
"575","96","5",17,4,7,6,6,38,8,1,4,9,37,3,7,2,1,0,88,65,153,17,75,11.1111111111111,49.0196078431373,42.483660130719,57.516339869281
"576","96","6",3,2,6,4,4,46,7,1,1,8,44,5,5,3,1,0,74,69,143,3,90,2.0979020979021,62.9370629370629,48.2517482517483,51.7482517482517
"577","97","1",15,16,16,12,11,14,17,10,16,13,9,15,17,10,10,1,113,92,205,16,23,7.80487804878049,11.219512195122,44.8780487804878,55.1219512195122
"578","97","2",9,9,18,5,14,19,9,5,8,14,16,9,8,6,5,4,90,71,161,13,35,8.07453416149068,21.7391304347826,44.0993788819876,55.9006211180124
"579","97","3",18,10,10,7,9,32,10,7,10,7,31,10,8,9,7,2,105,85,190,20,63,10.5263157894737,33.1578947368421,44.7368421052632,55.2631578947368
"580","97","4",9,9,13,10,16,19,8,4,9,14,22,3,7,5,4,2,89,68,157,11,41,7.00636942675159,26.1146496815287,43.312101910828,56.687898089172
"581","97","5",8,10,15,1,12,23,8,6,11,6,20,13,5,9,6,2,86,72,158,10,43,6.32911392405063,27.2151898734177,45.5696202531646,54.4303797468354
"582","97","6",8,12,17,3,16,48,6,5,12,8,47,8,4,7,5,3,117,95,212,11,95,5.18867924528302,44.811320754717,44.811320754717,55.188679245283
"583","98","1",8,4,10,7,13,21,9,4,4,12,25,6,3,10,4,3,78,68,146,11,46,7.53424657534247,31.5068493150685,46.5753424657534,53.4246575342466
"584","98","2",5,5,9,1,8,21,2,2,5,5,20,4,2,2,2,1,54,43,97,6,41,6.18556701030928,42.2680412371134,44.3298969072165,55.6701030927835
"585","98","3",12,5,6,0,3,29,2,0,4,1,26,2,2,0,0,0,58,37,95,12,55,12.6315789473684,57.8947368421053,38.9473684210526,61.0526315789474
"586","98","4",3,3,9,1,5,28,7,0,3,7,24,6,5,2,0,0,58,48,106,3,52,2.83018867924528,49.0566037735849,45.2830188679245,54.7169811320755
"587","98","5",0,0,3,3,1,35,8,1,0,6,33,5,5,4,1,0,52,56,108,0,68,0,62.962962962963,51.8518518518519,48.1481481481481
"588","98","6",3,4,7,0,7,41,2,0,4,3,40,2,0,2,0,0,65,53,118,3,81,2.54237288135593,68.6440677966102,44.9152542372881,55.0847457627119
"589","99","1",20,13,17,12,16,22,13,8,13,16,21,9,12,8,8,5,122,94,216,25,43,11.5740740740741,19.9074074074074,43.5185185185185,56.4814814814815
"590","99","2",18,13,16,6,16,18,10,5,13,9,18,10,5,10,5,1,103,73,176,19,36,10.7954545454545,20.4545454545455,41.4772727272727,58.5227272727273
"591","99","3",3,8,13,8,15,25,8,7,9,13,26,7,7,8,7,5,90,82,172,8,51,4.65116279069767,29.6511627906977,47.6744186046512,52.3255813953488
"592","99","4",3,6,11,4,13,38,9,5,6,9,39,10,2,12,5,2,90,87,177,5,77,2.82485875706215,43.5028248587571,49.1525423728814,50.8474576271186
"593","99","5",8,7,12,7,11,28,8,7,7,12,27,8,8,7,7,2,91,78,169,10,55,5.91715976331361,32.5443786982249,46.1538461538462,53.8461538461538
"594","99","6",11,9,14,4,9,23,12,3,8,9,18,11,9,6,3,3,87,68,155,14,41,9.03225806451613,26.4516129032258,43.8709677419355,56.1290322580645
