"","fish_id","bin","LLLL","LLLR","LLRL","LLRR","LRLL","LRLR","LRRL","LRRR","RLLL","RLLR","RLRL","RLRR","RRLL","RRLR","RRRL","RRRR","L","R","total_turns","reps","alts","rel_reps","rel_alts","rel_R","rel_L"
"1","1","1",4,5,6,6,9,51,9,5,5,7,55,8,3,11,5,3,97,98,195,7,106,3.58974358974359,54.3589743589744,50.2564102564103,49.7435897435897
"2","1","2",3,7,10,7,14,27,8,5,7,10,31,7,3,10,5,3,82,78,160,6,58,3.75,36.25,48.75,51.25
"3","1","3",11,7,7,7,7,14,7,10,7,7,14,11,7,10,10,53,71,121,192,64,28,33.3333333333333,14.5833333333333,63.0208333333333,36.9791666666667
"4","1","4",0,2,4,4,1,8,4,12,2,6,5,12,7,9,12,83,35,139,174,83,13,47.7011494252874,7.47126436781609,79.8850574712644,20.1149425287356
"5","1","5",0,1,3,0,2,10,2,12,1,3,9,14,2,13,13,49,32,105,137,49,19,35.7664233576642,13.8686131386861,76.6423357664234,23.3576642335766
"6","1","6",15,10,6,11,6,9,13,4,9,7,9,6,10,7,4,5,75,59,134,20,18,14.9253731343284,13.4328358208955,44.0298507462687,55.9701492537313
"7","10","1",6,6,15,5,9,32,11,6,6,14,26,13,11,7,6,2,91,87,178,8,58,4.49438202247191,32.5842696629214,48.876404494382,51.123595505618
"8","10","2",2,6,11,3,10,28,4,6,6,8,28,7,3,7,6,8,72,74,146,10,56,6.84931506849315,38.3561643835616,50.6849315068493,49.3150684931507
"9","10","3",4,2,6,0,4,31,2,1,2,3,29,3,1,2,1,1,51,44,95,5,60,5.26315789473684,63.1578947368421,46.3157894736842,53.6842105263158
"10","10","4",1,1,4,2,2,27,5,1,1,5,25,4,4,2,1,1,45,44,89,2,52,2.24719101123596,58.4269662921348,49.438202247191,50.561797752809
"11","10","5",0,1,2,2,2,25,4,1,1,3,24,3,2,3,1,0,38,39,77,0,49,0,63.6363636363636,50.6493506493507,49.3506493506493
"12","10","6",0,0,2,2,3,29,2,1,0,4,30,1,1,2,1,0,41,40,81,0,59,0,72.8395061728395,49.3827160493827,50.6172839506173
"13","100","1",10,7,7,4,6,16,7,7,7,4,15,10,4,10,7,7,65,66,131,17,31,12.9770992366412,23.6641221374046,50.381679389313,49.618320610687
"14","100","2",3,4,5,4,6,19,4,4,4,5,20,4,4,5,4,6,51,53,104,9,39,8.65384615384615,37.5,50.9615384615385,49.0384615384615
"15","100","3",0,1,1,2,3,19,5,0,1,2,21,3,0,5,0,0,32,34,66,0,40,0,60.6060606060606,51.5151515151515,48.4848484848485
"16","100","4",0,0,2,3,4,7,5,4,0,5,8,6,1,7,3,5,25,38,63,5,15,7.93650793650794,23.8095238095238,60.3174603174603,39.6825396825397
"17","100","5",0,0,1,2,1,32,6,1,0,3,32,5,2,6,2,3,44,55,99,3,64,3.03030303030303,64.6464646464647,55.5555555555556,44.4444444444444
"18","100","6",0,0,0,0,0,16,1,1,0,0,15,2,0,2,1,0,19,22,41,0,31,0,75.609756097561,53.6585365853659,46.3414634146341
"19","101","1",0,2,2,5,2,20,9,18,2,6,20,22,6,21,18,28,60,124,184,28,40,15.2173913043478,21.7391304347826,67.3913043478261,32.6086956521739
"20","101","2",0,2,6,6,7,21,8,15,2,11,21,17,6,17,15,25,67,115,182,25,42,13.7362637362637,23.0769230769231,63.1868131868132,36.8131868131868
"21","101","3",0,1,9,4,9,24,14,5,1,12,25,15,4,16,6,5,68,85,153,5,49,3.26797385620915,32.0261437908497,55.5555555555556,44.4444444444444
"22","101","4",2,2,5,2,6,57,6,4,1,5,59,8,0,10,4,10,86,98,184,12,116,6.52173913043478,63.0434782608696,53.2608695652174,46.7391304347826
"23","101","5",1,1,2,5,5,41,3,3,1,6,44,1,2,3,3,1,62,63,125,2,85,1.6,68,50.4,49.6
"24","101","6",5,5,9,5,9,12,9,5,5,9,12,9,5,8,4,9,59,64,123,14,24,11.3821138211382,19.5121951219512,52.0325203252033,47.9674796747967
"25","102","1",1,2,8,8,8,54,13,5,2,13,55,10,7,11,5,8,101,112,213,9,109,4.22535211267606,51.1737089201878,52.5821596244131,47.4178403755869
"26","102","2",0,3,4,4,4,24,9,13,3,5,24,18,4,17,12,29,61,115,176,29,48,16.4772727272727,27.2727272727273,65.3409090909091,34.6590909090909
"27","102","3",6,5,6,1,4,22,3,2,4,2,20,4,2,2,1,2,49,40,89,8,42,8.98876404494382,47.1910112359551,44.9438202247191,55.0561797752809
"28","102","4",0,0,1,0,0,8,0,0,0,1,8,0,1,0,0,0,11,11,22,0,16,0,72.7272727272727,50,50
"29","102","5",0,0,0,1,1,11,3,8,0,1,12,10,0,10,8,12,25,55,80,12,23,15,28.75,68.75,31.25
"30","102","6",0,0,0,0,0,3,1,7,0,0,3,8,0,8,7,22,11,51,62,22,6,35.4838709677419,9.67741935483871,82.258064516129,17.741935483871
"31","103","1",0,2,17,3,19,19,8,3,2,18,21,8,2,9,3,2,73,66,139,2,40,1.43884892086331,28.7769784172662,47.4820143884892,52.5179856115108
"32","103","2",1,3,4,7,5,10,5,7,3,8,12,5,5,7,7,9,44,57,101,10,22,9.9009900990099,21.7821782178218,56.4356435643564,43.5643564356436
"33","103","3",5,5,7,1,6,16,5,8,5,3,14,12,2,11,8,14,54,71,125,19,30,15.2,24,56.8,43.2
"34","103","4",5,4,5,1,5,11,4,6,4,2,12,8,1,9,6,5,43,48,91,10,23,10.989010989011,25.2747252747253,52.7472527472527,47.2527472527473
"35","103","5",0,1,9,2,8,21,5,4,1,11,20,7,3,6,4,4,52,57,109,4,41,3.6697247706422,37.6146788990826,52.2935779816514,47.7064220183486
"36","103","6",28,5,3,3,5,6,4,6,5,2,8,7,2,9,6,6,62,46,108,34,14,31.4814814814815,12.962962962963,42.5925925925926,57.4074074074074
"37","104","1",1,2,7,3,8,31,10,5,2,8,33,12,2,13,5,4,69,80,149,5,64,3.35570469798658,42.9530201342282,53.6912751677852,46.3087248322148
"38","104","2",0,0,3,0,2,22,12,4,0,3,21,17,1,15,4,0,44,63,107,0,43,0,40.1869158878505,58.8785046728972,41.1214953271028
"39","104","3",0,0,1,0,1,10,12,9,0,1,10,20,0,21,9,9,34,72,106,9,20,8.49056603773585,18.8679245283019,67.9245283018868,32.0754716981132
"40","104","4",3,4,6,6,8,13,6,4,4,8,15,4,4,5,3,6,50,52,102,9,28,8.82352941176471,27.4509803921569,50.9803921568627,49.0196078431373
"41","104","5",2,3,4,5,7,21,7,4,4,6,24,5,3,8,4,7,56,61,117,9,45,7.69230769230769,38.4615384615385,52.1367521367521,47.8632478632479
"42","104","6",31,12,13,4,12,12,6,1,12,5,10,3,6,1,1,0,93,39,132,31,22,23.4848484848485,16.6666666666667,29.5454545454545,70.4545454545455
"43","11","1",6,8,7,9,7,18,14,10,8,8,18,15,8,16,10,11,80,96,176,17,36,9.65909090909091,20.4545454545455,54.5454545454545,45.4545454545455
"44","11","2",0,4,2,6,5,9,8,6,4,5,12,8,4,10,6,14,42,64,106,14,21,13.2075471698113,19.811320754717,60.377358490566,39.622641509434
"45","11","3",2,3,1,5,2,1,4,3,3,3,2,2,4,3,3,2,23,23,46,4,3,8.69565217391304,6.52173913043478,50,50
"46","11","4",0,2,3,0,3,1,1,2,2,1,1,2,1,2,2,3,14,15,29,3,2,10.3448275862069,6.89655172413793,51.7241379310345,48.2758620689655
"47","11","5",0,0,2,0,0,2,1,2,0,2,1,2,2,1,2,0,9,11,20,0,3,0,15,55,45
"48","11","6",1,2,2,3,0,1,2,2,1,3,0,1,4,0,2,0,15,12,27,1,1,3.7037037037037,3.7037037037037,44.4444444444444,55.5555555555556
"49","12","1",11,15,15,11,11,15,15,12,14,11,11,16,14,13,12,6,106,99,205,17,26,8.29268292682927,12.6829268292683,48.2926829268293,51.7073170731707
"50","12","2",9,10,11,7,8,19,11,6,10,9,16,10,11,7,6,4,83,74,157,13,35,8.28025477707006,22.2929936305732,47.1337579617834,52.8662420382166
"51","12","3",102,11,10,2,12,3,2,0,12,1,4,0,1,1,0,0,145,19,164,102,7,62.1951219512195,4.26829268292683,11.5853658536585,88.4146341463415
"52","12","4",52,7,7,1,6,3,2,0,8,0,2,1,2,0,0,0,81,13,94,52,5,55.3191489361702,5.31914893617021,13.8297872340426,86.1702127659574
"53","12","5",56,10,11,0,10,6,1,0,9,1,5,1,0,0,0,0,95,18,113,56,11,49.5575221238938,9.73451327433628,15.929203539823,84.070796460177
"54","12","6",15,7,8,1,6,7,2,2,7,2,5,3,3,0,1,0,48,24,72,15,12,20.8333333333333,16.6666666666667,33.3333333333333,66.6666666666667
"55","13","1",21,16,16,7,19,19,6,5,16,7,22,4,5,6,5,4,111,70,181,25,41,13.8121546961326,22.6519337016575,38.6740331491713,61.3259668508287
"56","13","2",15,10,10,8,13,18,7,3,10,8,21,3,4,6,3,2,85,59,144,17,39,11.8055555555556,27.0833333333333,40.9722222222222,59.0277777777778
"57","13","3",0,0,2,1,1,4,1,0,0,2,4,0,1,0,0,0,11,8,19,0,8,0,42.1052631578947,42.1052631578947,57.8947368421053
"58","13","4",152,3,2,1,2,0,1,0,3,0,0,0,1,0,0,0,164,4,168,152,0,90.4761904761905,0,2.38095238095238,97.6190476190476
"59","13","5",43,3,4,1,3,1,1,0,2,2,1,0,1,0,0,0,58,7,65,43,2,66.1538461538462,3.07692307692308,10.7692307692308,89.2307692307692
"60","13","6",11,4,2,2,2,2,2,0,4,0,3,0,1,1,0,0,27,10,37,11,5,29.7297297297297,13.5135135135135,27.027027027027,72.972972972973
"61","14","1",5,5,6,8,7,10,6,8,5,9,11,6,6,7,8,12,56,66,122,17,21,13.9344262295082,17.2131147540984,54.0983606557377,45.9016393442623
"62","14","2",1,2,0,4,2,3,3,11,2,2,5,10,2,11,11,15,27,60,87,16,8,18.3908045977011,9.19540229885057,68.9655172413793,31.0344827586207
"63","14","3",0,0,0,0,0,0,0,1,0,0,0,0,0,0,0,0,1,3,4,0,0,0,0,75,25
"64","14","4",0,0,1,0,1,15,1,0,0,1,15,1,0,2,0,0,19,21,40,0,30,0,75,52.5,47.5
"65","14","5",0,2,2,3,1,9,4,1,2,3,8,2,4,1,2,4,23,28,51,4,17,7.84313725490196,33.3333333333333,54.9019607843137,45.0980392156863
"66","14","6",5,5,5,1,6,3,2,0,5,1,5,0,0,2,0,0,29,14,43,5,8,11.6279069767442,18.6046511627907,32.5581395348837,67.4418604651163
"67","15","1",6,8,8,9,12,10,9,11,7,9,14,11,5,15,11,15,75,88,163,21,24,12.8834355828221,14.7239263803681,53.9877300613497,46.0122699386503
"68","15","2",0,1,9,7,7,32,9,9,1,15,31,11,9,10,10,10,76,98,174,10,63,5.74712643678161,36.2068965517241,56.3218390804598,43.6781609195402
"69","15","3",3,7,10,4,11,24,7,7,7,7,25,10,4,11,7,2,75,74,149,5,49,3.35570469798658,32.8859060402685,49.6644295302013,50.3355704697987
"70","15","4",6,5,4,8,8,15,10,3,5,7,19,5,4,10,3,9,60,64,124,15,34,12.0967741935484,27.4193548387097,51.6129032258064,48.3870967741936
"71","15","5",9,8,10,6,10,9,7,5,8,7,9,6,5,7,5,2,65,51,116,11,18,9.48275862068965,15.5172413793103,43.9655172413793,56.0344827586207
"72","15","6",22,2,7,3,7,15,9,2,2,8,15,8,3,8,2,3,69,50,119,25,30,21.0084033613445,25.2100840336134,42.0168067226891,57.9831932773109
"73","16","1",0,2,4,5,3,15,12,10,2,7,14,17,6,16,10,13,52,87,139,13,29,9.35251798561151,20.863309352518,62.589928057554,37.410071942446
"74","16","2",1,1,4,3,6,29,6,4,1,7,30,7,2,8,4,2,56,62,118,3,59,2.54237288135593,50,52.5423728813559,47.4576271186441
"75","16","3",0,0,1,0,0,31,1,0,0,1,29,1,1,0,0,0,34,34,68,0,60,0,88.2352941176471,50,50
"76","16","4",5,2,2,2,3,27,3,1,2,3,27,2,2,2,1,1,47,41,88,6,54,6.81818181818182,61.3636363636364,46.5909090909091,53.4090909090909
"77","16","5",0,0,2,1,2,6,3,0,0,3,5,2,1,2,0,0,15,15,30,0,11,0,36.6666666666667,50,50
"78","16","6",1,1,3,1,2,3,1,1,1,3,3,1,1,1,1,5,15,17,32,6,6,18.75,18.75,53.125,46.875
"79","17","1",9,11,8,10,11,11,12,8,11,8,14,10,8,13,8,8,82,81,163,17,25,10.4294478527607,15.3374233128834,49.6932515337423,50.3067484662577
"80","17","2",3,4,3,7,2,9,11,5,4,6,8,9,9,8,5,5,46,55,101,8,17,7.92079207920792,16.8316831683168,54.4554455445545,45.5445544554455
"81","17","3",8,5,7,3,6,9,4,1,4,5,8,2,3,1,1,0,44,26,70,8,17,11.4285714285714,24.2857142857143,37.1428571428571,62.8571428571429
"82","17","4",0,0,1,3,2,2,3,4,0,4,3,4,2,5,5,9,16,34,50,9,5,18,10,68,32
"83","17","5",0,1,1,2,1,11,3,2,1,2,12,3,2,3,2,0,23,26,49,0,23,0,46.9387755102041,53.0612244897959,46.9387755102041
"84","17","6",0,0,5,0,2,10,3,2,0,5,7,5,3,3,2,2,23,29,52,2,17,3.84615384615385,32.6923076923077,55.7692307692308,44.2307692307692
"85","18","1",11,6,9,3,8,6,2,4,6,6,5,3,4,2,4,6,51,37,88,17,11,19.3181818181818,12.5,42.0454545454545,57.9545454545455
"86","18","2",13,9,8,4,6,7,3,4,9,3,5,3,6,1,4,3,57,34,91,16,12,17.5824175824176,13.1868131868132,37.3626373626374,62.6373626373626
"87","18","3",8,7,9,5,9,2,5,0,7,6,3,0,4,1,0,0,47,22,69,8,5,11.5942028985507,7.2463768115942,31.8840579710145,68.1159420289855
"88","18","4",2,2,4,4,5,4,5,3,2,6,6,3,3,5,3,3,31,32,63,5,10,7.93650793650794,15.8730158730159,50.7936507936508,49.2063492063492
"89","18","5",1,4,3,4,1,6,3,4,4,3,4,2,6,1,4,7,27,33,60,8,10,13.3333333333333,16.6666666666667,55,45
"90","18","6",2,1,2,1,4,1,0,1,1,2,2,0,0,1,1,0,14,8,22,2,3,9.09090909090909,13.6363636363636,36.3636363636364,63.6363636363636
"91","19","1",5,4,10,4,9,28,13,5,4,10,27,15,5,14,6,14,79,97,176,19,55,10.7954545454545,31.25,55.1136363636364,44.8863636363636
"92","19","2",4,5,6,3,6,11,4,6,5,4,11,7,3,7,6,18,46,63,109,22,22,20.1834862385321,20.1834862385321,57.7981651376147,42.2018348623853
"93","19","3",1,1,4,2,5,17,3,2,1,5,19,2,1,4,2,1,37,36,73,2,36,2.73972602739726,49.3150684931507,49.3150684931507,50.6849315068493
"94","19","4",1,1,5,4,5,28,4,6,1,8,29,6,4,6,6,12,56,73,129,13,57,10.077519379845,44.1860465116279,56.5891472868217,43.4108527131783
"95","19","5",4,4,6,4,7,15,4,3,4,7,16,3,4,4,4,6,49,49,98,10,31,10.2040816326531,31.6326530612245,50,50
"96","19","6",1,1,0,2,1,10,3,5,1,1,11,5,1,7,5,4,24,37,61,5,21,8.19672131147541,34.4262295081967,60.655737704918,39.344262295082
"97","2","1",4,4,4,9,6,10,7,9,5,8,12,7,7,9,9,11,56,68,124,15,22,12.0967741935484,17.741935483871,54.8387096774194,45.1612903225806
"98","2","2",2,6,9,1,5,10,9,4,6,5,6,12,6,7,4,2,48,49,97,4,16,4.12371134020619,16.4948453608247,50.5154639175258,49.4845360824742
"99","2","3",0,0,2,5,4,10,6,6,0,7,12,8,3,9,6,12,34,59,93,12,22,12.9032258064516,23.6559139784946,63.4408602150538,36.5591397849462
"100","2","4",5,1,4,5,3,6,6,4,1,9,5,4,7,3,4,7,36,41,77,12,11,15.5844155844156,14.2857142857143,53.2467532467532,46.7532467532468
"101","2","5",0,1,3,2,2,3,2,3,1,4,2,4,3,2,3,6,17,27,44,6,5,13.6363636363636,11.3636363636364,61.3636363636364,38.6363636363636
"102","2","6",0,0,3,0,0,9,2,1,0,2,6,3,2,1,1,2,16,19,35,2,15,5.71428571428571,42.8571428571429,54.2857142857143,45.7142857142857
"103","20","1",17,9,11,5,8,17,6,2,9,7,14,2,8,0,2,1,76,45,121,18,31,14.8760330578512,25.6198347107438,37.1900826446281,62.8099173553719
"104","20","2",1,3,5,5,6,16,5,5,3,8,17,5,5,6,5,4,48,54,102,5,33,4.90196078431373,32.3529411764706,52.9411764705882,47.0588235294118
"105","20","3",2,2,4,2,3,12,4,2,3,4,10,4,4,2,2,4,34,33,67,6,22,8.95522388059701,32.8358208955224,49.2537313432836,50.7462686567164
"106","20","4",1,1,1,3,3,31,2,2,1,3,34,1,1,3,2,1,46,47,93,2,65,2.1505376344086,69.8924731182796,50.5376344086022,49.4623655913978
"107","20","5",1,2,0,2,0,7,3,2,2,0,8,3,2,3,2,1,19,22,41,2,15,4.8780487804878,36.5853658536585,53.6585365853659,46.3414634146341
"108","20","6",9,11,8,5,11,18,6,3,11,3,20,4,3,6,3,2,73,53,126,11,38,8.73015873015873,30.1587301587302,42.0634920634921,57.9365079365079
"109","21","1",0,0,1,0,0,12,1,4,0,1,11,5,1,4,4,5,19,33,52,5,23,9.61538461538461,44.2307692307692,63.4615384615385,36.5384615384615
"110","21","2",0,0,0,0,0,0,0,0,0,0,1,0,0,0,0,0,2,2,4,0,1,0,25,50,50
"111","21","3",0,0,0,0,0,0,0,0,0,0,1,0,0,1,0,0,2,3,5,0,1,0,20,60,40
"112","21","4",0,0,0,0,0,0,0,0,0,1,0,0,0,0,0,0,2,2,4,0,0,0,0,50,50
"113","21","5",0,0,0,0,0,0,0,0,0,0,0,0,0,0,0,0,0,1,1,0,0,0,0,100,0
"114","21","6",0,0,0,0,0,0,0,0,0,0,0,0,0,0,0,0,0,0,0,0,0,NA,NA,NA,NA
"115","22","1",8,8,11,8,14,20,15,3,8,11,23,10,5,13,3,3,88,78,166,11,43,6.62650602409639,25.9036144578313,46.9879518072289,53.0120481927711
"116","22","2",1,1,1,0,1,66,1,0,1,0,65,1,0,0,0,0,72,69,141,1,131,0.709219858156028,92.9078014184397,48.936170212766,51.063829787234
"117","22","3",2,2,3,0,2,53,2,3,2,1,52,5,1,4,3,1,68,71,139,3,105,2.15827338129496,75.5395683453237,51.0791366906475,48.9208633093525
"118","22","4",0,0,1,0,1,59,0,0,0,1,59,0,0,0,0,0,63,61,124,0,118,0,95.1612903225806,49.1935483870968,50.8064516129032
"119","22","5",0,1,7,0,7,14,1,0,1,6,15,1,0,1,0,0,32,25,57,0,29,0,50.8771929824561,43.859649122807,56.140350877193
"120","22","6",0,0,1,0,1,19,0,0,0,1,19,0,0,0,0,0,23,21,44,0,38,0,86.3636363636364,47.7272727272727,52.2727272727273
"121","23","1",4,8,11,4,9,56,8,5,8,7,54,9,6,8,6,3,106,103,209,7,110,3.34928229665072,52.6315789473684,49.2822966507177,50.7177033492823
"122","23","2",6,6,6,4,8,26,10,4,6,4,28,10,2,11,3,4,70,71,141,10,54,7.09219858156028,38.2978723404255,50.354609929078,49.645390070922
"123","23","3",11,7,13,5,10,20,10,3,7,11,17,8,9,4,3,3,81,63,144,14,37,9.72222222222222,25.6944444444444,43.75,56.25
"124","23","4",110,16,18,3,19,0,4,0,16,5,2,0,2,2,0,0,172,28,200,110,2,55,1,14,86
"125","23","5",106,6,6,0,6,2,0,0,6,0,2,0,0,0,0,0,129,8,137,106,4,77.3722627737226,2.91970802919708,5.83941605839416,94.1605839416058
"126","23","6",80,0,0,0,0,0,0,0,0,0,0,0,0,0,0,0,83,0,83,80,0,96.3855421686747,0,0,100
"127","24","1",4,5,9,7,11,32,9,3,5,11,35,4,5,7,3,2,82,73,155,6,67,3.87096774193548,43.2258064516129,47.0967741935484,52.9032258064516
"128","24","2",0,0,3,5,6,25,7,0,0,8,29,2,2,6,0,0,48,48,96,0,54,0,56.25,50,50
"129","24","3",0,0,0,5,4,31,6,0,0,5,36,0,1,5,0,0,48,48,96,0,67,0,69.7916666666667,50,50
"130","24","4",3,3,2,6,6,31,6,4,3,5,36,4,2,8,4,6,63,69,132,9,67,6.81818181818182,50.7575757575758,52.2727272727273,47.7272727272727
"131","24","5",5,2,7,4,6,43,10,13,2,9,42,19,5,18,13,21,91,131,222,26,85,11.7117117117117,38.2882882882883,59.009009009009,40.990990990991
"132","24","6",1,1,4,2,4,26,7,11,1,5,25,16,2,15,10,41,56,118,174,42,51,24.1379310344828,29.3103448275862,67.816091954023,32.183908045977
"133","25","1",26,9,10,4,10,19,7,7,9,6,19,10,5,9,7,8,94,74,168,34,38,20.2380952380952,22.6190476190476,44.0476190476191,55.9523809523809
"134","25","2",22,14,16,4,16,3,4,3,15,5,3,3,4,3,3,3,85,39,124,25,6,20.1612903225806,4.83870967741935,31.4516129032258,68.5483870967742
"135","25","3",7,5,4,4,4,3,2,2,5,2,3,0,3,1,2,2,32,20,52,9,6,17.3076923076923,11.5384615384615,38.4615384615385,61.5384615384615
"136","25","4",1,2,3,2,1,8,2,4,2,2,6,4,3,2,3,5,23,30,53,6,14,11.3207547169811,26.4150943396226,56.6037735849057,43.3962264150943
"137","25","5",4,2,2,2,2,3,2,3,2,2,3,2,2,2,2,0,20,18,38,4,6,10.5263157894737,15.7894736842105,47.3684210526316,52.6315789473684
"138","25","6",2,2,4,0,2,5,1,0,2,2,3,2,1,0,0,0,17,12,29,2,8,6.89655172413793,27.5862068965517,41.3793103448276,58.6206896551724
"139","26","1",6,7,12,4,11,40,7,7,7,9,39,11,5,10,7,7,95,97,192,13,79,6.77083333333333,41.1458333333333,50.5208333333333,49.4791666666667
"140","26","2",0,0,2,2,3,54,7,1,0,4,54,6,1,7,1,1,70,76,146,1,108,0.684931506849315,73.972602739726,52.0547945205479,47.9452054794521
"141","26","3",2,4,8,5,9,36,10,2,4,9,36,7,4,8,2,1,77,73,150,3,72,2,48,48.6666666666667,51.3333333333333
"142","26","4",0,1,6,7,7,32,12,6,1,12,33,11,6,12,6,11,73,93,166,11,65,6.62650602409639,39.1566265060241,56.0240963855422,43.9759036144578
"143","26","5",2,5,9,5,8,29,11,4,5,9,28,10,5,9,3,2,73,74,147,4,57,2.72108843537415,38.7755102040816,50.3401360544218,49.6598639455782
"144","26","6",4,4,6,4,6,36,7,2,3,7,36,5,4,5,2,2,71,65,136,6,72,4.41176470588235,52.9411764705882,47.7941176470588,52.2058823529412
"145","27","1",8,6,10,10,14,26,10,4,6,14,31,3,6,8,4,6,90,79,169,14,57,8.28402366863905,33.7278106508876,46.7455621301775,53.2544378698225
"146","27","2",9,6,15,3,15,19,10,4,6,12,19,11,3,11,4,3,83,70,153,12,38,7.84313725490196,24.8366013071895,45.7516339869281,54.2483660130719
"147","27","3",23,10,10,10,10,22,13,2,10,10,23,5,10,6,3,3,102,71,173,26,45,15.028901734104,26.0115606936416,41.0404624277457,58.9595375722543
"148","27","4",27,11,16,2,13,23,7,2,10,7,20,7,4,5,2,3,102,60,162,30,43,18.5185185185185,26.5432098765432,37.037037037037,62.962962962963
"149","27","5",0,2,6,10,12,30,14,0,2,14,35,4,4,10,0,0,75,71,146,0,65,0,44.5205479452055,48.6301369863014,51.3698630136986
"150","27","6",2,2,4,3,3,33,6,4,2,5,32,7,4,6,4,2,59,63,122,4,65,3.27868852459016,53.2786885245902,51.6393442622951,48.3606557377049
"151","28","1",8,6,10,10,9,15,16,7,6,14,13,13,11,11,6,5,81,82,163,13,28,7.97546012269939,17.1779141104294,50.3067484662577,49.6932515337423
"152","28","2",4,7,11,3,12,18,3,4,7,8,18,4,3,4,4,6,64,55,119,10,36,8.40336134453782,30.2521008403361,46.218487394958,53.781512605042
"153","28","3",4,3,8,2,6,8,5,8,3,7,6,11,5,8,8,17,46,66,112,21,14,18.75,12.5,58.9285714285714,41.0714285714286
"154","28","4",4,7,11,0,6,19,4,5,7,4,15,9,5,4,5,5,58,55,113,9,34,7.9646017699115,30.0884955752212,48.6725663716814,51.3274336283186
"155","28","5",2,6,14,6,16,10,3,5,6,14,12,2,4,4,5,4,63,53,116,6,22,5.17241379310345,18.9655172413793,45.6896551724138,54.3103448275862
"156","28","6",4,5,14,2,15,21,1,1,5,11,21,1,1,1,1,1,64,44,108,5,42,4.62962962962963,38.8888888888889,40.7407407407407,59.2592592592593
"157","29","1",5,8,10,6,12,23,7,6,8,8,25,7,4,9,6,5,77,75,152,10,48,6.57894736842105,31.5789473684211,49.3421052631579,50.6578947368421
"158","29","2",1,5,4,5,4,14,5,5,4,4,14,6,4,6,5,3,44,48,92,4,28,4.34782608695652,30.4347826086957,52.1739130434783,47.8260869565217
"159","29","3",1,2,3,6,2,4,8,4,2,7,3,5,7,4,3,0,30,34,64,1,7,1.5625,10.9375,53.125,46.875
"160","29","4",0,2,3,2,4,6,4,2,2,3,6,4,1,4,1,0,23,24,47,0,12,0,25.531914893617,51.063829787234,48.936170212766
"161","29","5",0,0,3,3,3,5,2,3,0,6,6,2,2,3,3,1,21,24,45,1,11,2.22222222222222,24.4444444444444,53.3333333333333,46.6666666666667
"162","29","6",0,0,0,0,0,2,1,4,0,0,2,4,0,4,3,15,7,31,38,15,4,39.4736842105263,10.5263157894737,81.5789473684211,18.4210526315789
"163","3","1",5,9,11,9,14,23,13,4,9,12,26,8,7,10,4,2,90,79,169,7,49,4.14201183431953,28.9940828402367,46.7455621301775,53.2544378698225
"164","3","2",13,11,8,8,2,11,14,10,11,5,5,16,14,10,10,7,78,80,158,20,16,12.6582278481013,10.126582278481,50.6329113924051,49.3670886075949
"165","3","3",2,3,7,7,10,30,7,17,3,11,33,17,4,20,17,15,84,122,206,17,63,8.25242718446602,30.5825242718447,59.2233009708738,40.7766990291262
"166","3","4",3,6,6,9,5,13,7,14,6,8,12,12,9,11,13,13,63,87,150,16,25,10.6666666666667,16.6666666666667,58,42
"167","3","5",0,1,0,4,2,6,6,13,1,3,8,15,2,18,13,29,33,91,124,29,14,23.3870967741935,11.2903225806452,73.3870967741936,26.6129032258065
"168","3","6",0,2,4,4,6,5,6,7,2,6,7,10,2,12,8,22,35,71,106,22,12,20.7547169811321,11.3207547169811,66.9811320754717,33.0188679245283
"169","30","1",3,3,5,7,5,14,7,12,3,8,14,13,6,13,12,12,57,83,140,15,28,10.7142857142857,20,59.2857142857143,40.7142857142857
"170","30","2",6,7,8,3,5,17,6,10,7,3,14,13,5,11,10,11,63,76,139,17,31,12.2302158273381,22.3021582733813,54.6762589928058,45.3237410071942
"171","30","3",0,5,7,5,4,20,12,5,5,7,17,12,8,9,5,4,60,68,128,4,37,3.125,28.90625,53.125,46.875
"172","30","4",0,0,0,6,3,9,9,12,0,6,12,14,4,17,12,22,41,88,129,22,21,17.0542635658915,16.2790697674419,68.2170542635659,31.7829457364341
"173","30","5",0,1,4,2,2,17,2,14,1,5,15,14,4,12,14,16,43,83,126,16,32,12.6984126984127,25.3968253968254,65.8730158730159,34.1269841269841
"174","30","6",0,3,8,2,5,29,3,6,3,7,25,7,5,4,6,9,57,68,125,9,54,7.2,43.2,54.4,45.6
"175","31","1",7,9,10,7,11,21,8,4,9,8,22,5,6,6,4,6,79,67,146,13,43,8.9041095890411,29.4520547945205,45.8904109589041,54.1095890410959
"176","31","2",3,7,5,9,7,17,8,9,7,7,19,9,7,10,9,12,66,82,148,15,36,10.1351351351351,24.3243243243243,55.4054054054054,44.5945945945946
"177","31","3",0,1,1,2,0,8,3,10,1,2,6,11,3,9,9,37,25,81,106,37,14,34.9056603773585,13.2075471698113,76.4150943396226,23.5849056603774
"178","31","4",1,3,0,4,0,2,4,9,3,1,2,9,4,9,9,21,24,60,84,22,4,26.1904761904762,4.76190476190476,71.4285714285714,28.5714285714286
"179","31","5",1,1,1,0,0,2,0,4,1,0,1,4,1,4,5,22,10,40,50,23,3,46,6,80,20
"180","31","6",0,0,0,1,0,0,0,3,0,1,0,2,1,2,3,15,4,27,31,15,0,48.3870967741936,0,87.0967741935484,12.9032258064516
"181","32","1",9,6,8,7,10,19,11,5,6,8,21,9,5,11,5,2,77,68,145,11,40,7.58620689655172,27.5862068965517,46.8965517241379,53.1034482758621
"182","32","2",2,3,4,5,7,12,7,4,3,7,15,6,3,8,4,3,46,50,96,5,27,5.20833333333333,28.125,52.0833333333333,47.9166666666667
"183","32","3",0,2,6,4,6,15,8,5,2,8,14,9,4,8,5,6,47,58,105,6,29,5.71428571428571,27.6190476190476,55.2380952380952,44.7619047619048
"184","32","4",1,1,3,2,2,4,4,7,1,4,4,8,3,8,7,5,26,41,67,6,8,8.95522388059701,11.9402985074627,61.1940298507463,38.8059701492537
"185","32","5",2,2,3,4,3,5,4,5,2,5,5,5,4,5,4,4,28,37,65,6,10,9.23076923076923,15.3846153846154,56.9230769230769,43.0769230769231
"186","32","6",0,0,3,1,0,8,3,3,0,4,5,5,5,2,4,6,20,32,52,6,13,11.5384615384615,25,61.5384615384615,38.4615384615385
"187","33","1",4,5,6,10,5,15,13,12,5,11,14,15,11,15,13,17,71,103,174,21,29,12.0689655172414,16.6666666666667,59.1954022988506,40.8045977011494
"188","33","2",5,5,8,3,7,24,13,6,5,6,24,16,4,15,6,11,73,88,161,16,48,9.93788819875776,29.8136645962733,54.6583850931677,45.3416149068323
"189","33","3",0,2,5,6,7,23,12,5,2,9,25,11,4,13,6,3,61,75,136,3,48,2.20588235294118,35.2941176470588,55.1470588235294,44.8529411764706
"190","33","4",6,4,7,5,6,36,12,11,4,8,35,18,6,16,10,7,87,107,194,13,71,6.70103092783505,36.5979381443299,55.1546391752577,44.8453608247423
"191","33","5",3,6,9,5,7,19,10,6,6,7,18,11,6,10,6,3,67,68,135,6,37,4.44444444444444,27.4074074074074,50.3703703703704,49.6296296296296
"192","33","6",4,2,4,8,9,35,13,5,3,10,40,10,4,14,5,5,83,91,174,9,75,5.17241379310345,43.1034482758621,52.2988505747126,47.7011494252874
"193","34","1",2,7,12,5,9,43,12,3,7,10,40,10,8,7,3,3,94,90,184,5,83,2.71739130434783,45.1086956521739,48.9130434782609,51.0869565217391
"194","34","2",0,1,7,5,8,22,9,9,1,11,22,13,4,14,9,2,62,78,140,2,44,1.42857142857143,31.4285714285714,55.7142857142857,44.2857142857143
"195","34","3",1,1,3,0,1,18,7,8,1,2,17,14,2,13,8,9,41,67,108,10,35,9.25925925925926,32.4074074074074,62.037037037037,37.962962962963
"196","34","4",18,5,9,5,13,22,9,4,6,9,26,8,2,11,4,1,88,67,155,19,48,12.258064516129,30.9677419354839,43.2258064516129,56.7741935483871
"197","34","5",31,16,15,5,18,18,8,2,16,4,21,5,2,8,2,1,115,60,175,32,39,18.2857142857143,22.2857142857143,34.2857142857143,65.7142857142857
"198","34","6",6,7,11,4,11,35,9,0,7,8,34,5,4,5,0,0,84,65,149,6,69,4.02684563758389,46.3087248322148,43.6241610738255,56.3758389261745
"199","35","1",7,6,13,3,8,20,11,3,6,10,15,10,8,6,3,2,72,62,134,9,35,6.71641791044776,26.1194029850746,46.2686567164179,53.7313432835821
"200","35","2",0,4,4,4,6,26,9,8,4,4,28,13,2,15,7,4,61,80,141,4,54,2.83687943262411,38.2978723404255,56.7375886524823,43.2624113475177
"201","35","3",0,1,6,5,5,23,6,8,1,10,22,9,6,8,8,9,55,75,130,9,45,6.92307692307692,34.6153846153846,57.6923076923077,42.3076923076923
"202","35","4",2,1,4,1,4,19,5,2,1,4,18,6,2,5,2,0,40,39,79,2,37,2.53164556962025,46.8354430379747,49.3670886075949,50.6329113924051
"203","35","5",2,1,2,2,2,14,2,2,1,3,14,2,2,1,2,1,28,28,56,3,28,5.35714285714286,50,50,50
"204","35","6",0,0,2,0,1,17,1,0,0,2,16,1,1,0,0,0,22,22,44,0,33,0,75,50,50
"205","36","1",9,7,6,5,10,20,9,8,7,5,23,12,2,15,8,5,76,78,154,14,43,9.09090909090909,27.9220779220779,50.6493506493507,49.3506493506493
"206","36","2",0,4,4,5,4,8,4,14,4,5,8,13,5,13,14,24,45,87,132,24,16,18.1818181818182,12.1212121212121,65.9090909090909,34.0909090909091
"207","36","3",0,4,4,2,2,24,5,7,4,2,22,10,4,8,7,1,49,60,109,1,46,0.917431192660551,42.2018348623853,55.045871559633,44.954128440367
"208","36","4",0,2,6,7,8,16,7,11,2,11,19,11,5,13,11,14,59,87,146,14,35,9.58904109589041,23.972602739726,59.5890410958904,40.4109589041096
"209","36","5",1,2,4,7,6,8,8,2,2,9,10,3,4,6,2,2,39,40,79,3,18,3.79746835443038,22.7848101265823,50.6329113924051,49.3670886075949
"210","36","6",0,0,7,3,5,25,10,2,0,10,22,9,5,7,2,2,53,59,112,2,47,1.78571428571429,41.9642857142857,52.6785714285714,47.3214285714286
"211","37","1",1,5,8,8,5,14,10,5,5,11,10,7,11,3,5,1,57,55,112,2,24,1.78571428571429,21.4285714285714,49.1071428571429,50.8928571428571
"212","37","2",5,5,6,3,6,12,7,2,5,4,12,6,3,6,2,3,47,43,90,8,24,8.88888888888889,26.6666666666667,47.7777777777778,52.2222222222222
"213","37","3",4,2,4,2,4,4,4,3,2,4,4,5,2,4,2,1,27,27,54,5,8,9.25925925925926,14.8148148148148,50,50
"214","37","4",1,2,2,1,2,9,4,0,2,1,9,3,1,3,0,0,23,20,43,1,18,2.32558139534884,41.8604651162791,46.5116279069767,53.4883720930233
"215","37","5",62,3,5,2,5,6,4,0,4,4,5,2,3,1,0,0,90,19,109,62,11,56.8807339449541,10.0917431192661,17.4311926605505,82.5688073394495
"216","37","6",82,7,6,1,7,3,1,0,7,1,3,0,1,0,0,0,109,13,122,82,6,67.2131147540984,4.91803278688525,10.655737704918,89.344262295082
"217","38","1",8,9,11,6,12,18,5,10,9,8,19,9,5,11,11,16,80,90,170,24,37,14.1176470588235,21.7647058823529,52.9411764705882,47.0588235294118
"218","38","2",6,6,12,3,7,20,8,8,6,9,15,14,8,8,8,17,71,87,158,23,35,14.5569620253165,22.1518987341772,55.0632911392405,44.9367088607595
"219","38","3",10,6,14,5,7,22,14,2,6,13,15,11,12,4,2,4,83,67,150,14,37,9.33333333333333,24.6666666666667,44.6666666666667,55.3333333333333
"220","38","4",8,6,8,1,6,18,5,3,6,4,16,7,3,5,3,0,57,45,102,8,34,7.84313725490196,33.3333333333333,44.1176470588235,55.8823529411765
"221","38","5",5,8,8,3,9,15,8,6,9,3,16,11,2,12,6,5,65,64,129,10,31,7.75193798449612,24.031007751938,49.6124031007752,50.3875968992248
"222","38","6",4,9,6,6,6,4,12,9,9,3,4,14,6,14,8,12,56,73,129,16,8,12.4031007751938,6.2015503875969,56.5891472868217,43.4108527131783
"223","39","1",2,3,2,6,2,5,8,7,3,5,5,9,5,10,7,7,36,53,89,9,10,10.1123595505618,11.2359550561798,59.5505617977528,40.4494382022472
"224","39","2",3,4,5,4,6,8,6,2,4,5,10,4,3,5,2,0,40,34,74,3,18,4.05405405405405,24.3243243243243,45.9459459459459,54.0540540540541
"225","39","3",0,1,1,1,2,1,0,4,1,1,2,3,0,4,4,11,10,29,39,11,3,28.2051282051282,7.69230769230769,74.3589743589744,25.6410256410256
"226","39","4",1,2,3,0,2,4,3,1,2,1,3,4,1,4,2,7,17,26,43,8,7,18.6046511627907,16.2790697674419,60.4651162790698,39.5348837209302
"227","39","5",0,0,1,0,0,4,1,1,0,1,2,2,1,0,0,1,7,10,17,1,6,5.88235294117647,35.2941176470588,58.8235294117647,41.1764705882353
"228","39","6",0,0,0,0,0,4,0,2,0,0,5,1,0,2,2,2,8,13,21,2,9,9.52380952380952,42.8571428571429,61.9047619047619,38.0952380952381
"229","4","1",15,13,17,9,18,22,10,6,14,12,23,7,8,8,6,4,113,82,195,19,45,9.74358974358974,23.0769230769231,42.0512820512821,57.9487179487179
"230","4","2",24,21,24,9,24,19,9,4,21,12,18,4,9,3,4,2,135,75,210,26,37,12.3809523809524,17.6190476190476,35.7142857142857,64.2857142857143
"231","4","3",15,14,15,8,16,31,11,1,14,9,31,5,7,5,1,4,112,78,190,19,62,10,32.6315789473684,41.0526315789474,58.9473684210526
"232","4","4",20,13,12,10,13,5,9,3,13,9,7,2,8,4,3,2,87,49,136,22,12,16.1764705882353,8.82352941176471,36.0294117647059,63.9705882352941
"233","4","5",7,4,6,2,4,8,5,2,4,4,6,5,4,3,2,1,39,31,70,8,14,11.4285714285714,20,44.2857142857143,55.7142857142857
"234","4","6",24,6,6,4,7,5,3,2,6,4,5,1,3,1,2,3,58,27,85,27,10,31.7647058823529,11.7647058823529,31.7647058823529,68.2352941176471
"235","40","1",12,6,5,12,9,19,9,7,6,11,22,4,8,8,7,4,80,72,152,16,41,10.5263157894737,26.9736842105263,47.3684210526316,52.6315789473684
"236","40","2",0,2,6,8,9,26,10,3,2,12,30,5,5,9,4,1,66,69,135,1,56,0.740740740740741,41.4814814814815,51.1111111111111,48.8888888888889
"237","40","3",0,1,2,1,1,20,6,3,1,2,20,8,2,7,3,5,36,49,85,5,40,5.88235294117647,47.0588235294118,57.6470588235294,42.3529411764706
"238","40","4",0,0,0,1,1,12,2,1,0,1,14,2,0,3,1,2,19,24,43,2,26,4.65116279069767,60.4651162790698,55.8139534883721,44.1860465116279
"239","40","5",0,1,1,1,1,23,7,1,1,1,24,7,1,7,1,0,37,43,80,0,47,0,58.75,53.75,46.25
"240","40","6",0,0,0,1,1,17,2,0,0,1,19,1,0,2,0,0,23,24,47,0,36,0,76.5957446808511,51.063829787234,48.936170212766
"241","41","1",3,3,5,4,3,15,15,6,3,6,13,18,6,15,6,8,55,77,132,11,28,8.33333333333333,21.2121212121212,58.3333333333333,41.6666666666667
"242","41","2",2,4,12,0,11,15,3,3,4,8,13,6,1,5,3,2,51,44,95,4,28,4.21052631578947,29.4736842105263,46.3157894736842,53.6842105263158
"243","41","3",6,2,4,0,4,13,5,4,3,2,13,9,1,9,5,4,41,46,87,10,26,11.4942528735632,29.8850574712644,52.8735632183908,47.1264367816092
"244","41","4",1,1,4,0,2,28,2,1,1,3,25,3,2,1,1,4,40,42,82,5,53,6.09756097560976,64.6341463414634,51.219512195122,48.780487804878
"245","41","5",35,8,5,5,6,3,4,3,8,3,3,2,5,2,3,3,71,30,101,38,6,37.6237623762376,5.94059405940594,29.7029702970297,70.2970297029703
"246","41","6",3,2,6,3,6,6,5,0,2,6,6,2,2,3,0,0,32,23,55,3,12,5.45454545454545,21.8181818181818,41.8181818181818,58.1818181818182
"247","42","1",8,6,5,10,3,19,18,8,6,9,17,16,12,14,8,13,79,96,175,21,36,12,20.5714285714286,54.8571428571429,45.1428571428571
"248","42","2",0,0,5,4,4,22,9,3,0,9,21,8,4,8,3,4,48,59,107,4,43,3.73831775700935,40.1869158878505,55.1401869158879,44.8598130841121
"249","42","3",0,0,1,2,3,12,3,0,0,3,15,1,0,3,0,0,23,23,46,0,27,0,58.695652173913,50,50
"250","42","4",0,0,1,1,2,7,1,0,0,2,8,0,0,1,0,0,13,13,26,0,15,0,57.6923076923077,50,50
"251","42","5",0,0,4,1,4,23,5,0,0,5,23,4,1,4,0,0,38,39,77,0,46,0,59.7402597402597,50.6493506493507,49.3506493506493
"252","42","6",4,4,7,1,6,26,3,0,4,4,26,2,2,1,0,0,53,40,93,4,52,4.3010752688172,55.9139784946237,43.010752688172,56.989247311828
"253","43","1",13,12,13,9,13,14,9,3,12,11,14,3,9,3,3,1,88,57,145,14,28,9.6551724137931,19.3103448275862,39.3103448275862,60.6896551724138
"254","43","2",20,10,12,10,10,25,16,4,10,12,22,10,12,7,4,4,108,83,191,24,47,12.565445026178,24.6073298429319,43.455497382199,56.544502617801
"255","43","3",37,17,17,7,15,15,10,3,18,7,12,6,10,3,3,2,124,61,185,39,27,21.0810810810811,14.5945945945946,32.972972972973,67.027027027027
"256","43","4",8,7,6,7,4,17,10,16,7,6,14,19,9,16,15,46,75,135,210,54,31,25.7142857142857,14.7619047619048,64.2857142857143,35.7142857142857
"257","43","5",2,2,0,4,3,22,5,20,2,2,25,21,1,24,20,36,59,133,192,38,47,19.7916666666667,24.4791666666667,69.2708333333333,30.7291666666667
"258","43","6",7,8,10,5,10,12,10,3,8,7,13,7,5,8,3,5,67,57,124,12,25,9.67741935483871,20.1612903225806,45.9677419354839,54.0322580645161
"259","44","1",14,12,16,7,12,23,10,12,12,11,19,15,12,11,12,15,108,108,216,29,42,13.4259259259259,19.4444444444444,50,50
"260","44","2",0,8,8,9,10,25,7,12,8,9,28,10,7,13,12,22,81,110,191,22,53,11.5183246073298,27.7486910994764,57.5916230366492,42.4083769633508
"261","44","3",23,12,10,8,9,16,10,6,12,6,16,8,9,8,7,4,96,71,167,27,32,16.1676646706587,19.1616766467066,42.5149700598802,57.4850299401198
"262","44","4",6,7,7,4,3,12,4,9,7,4,9,9,8,6,10,2,54,56,110,8,21,7.27272727272727,19.0909090909091,50.9090909090909,49.0909090909091
"263","44","5",4,3,3,7,6,6,7,4,4,7,9,4,5,6,4,7,43,46,89,11,15,12.3595505617978,16.8539325842697,51.685393258427,48.314606741573
"264","44","6",3,5,7,2,5,13,3,4,5,4,11,5,5,3,4,2,44,40,84,5,24,5.95238095238095,28.5714285714286,47.6190476190476,52.3809523809524
"265","45","1",9,6,13,5,11,11,5,11,6,12,10,10,7,9,11,10,73,76,149,19,21,12.751677852349,14.0939597315436,51.006711409396,48.993288590604
"266","45","2",3,6,12,2,9,20,8,7,6,8,17,13,6,10,8,2,69,71,140,5,37,3.57142857142857,26.4285714285714,50.7142857142857,49.2857142857143
"267","45","3",3,6,10,2,8,18,7,5,6,7,15,10,5,7,5,4,61,60,121,7,33,5.78512396694215,27.2727272727273,49.5867768595041,50.4132231404959
"268","45","4",3,1,3,1,0,11,4,3,1,3,9,6,4,4,4,18,28,50,78,21,20,26.9230769230769,25.6410256410256,64.1025641025641,35.8974358974359
"269","45","5",12,4,4,4,3,5,3,4,4,4,4,3,4,3,4,9,40,37,77,21,9,27.2727272727273,11.6883116883117,48.0519480519481,51.9480519480519
"270","45","6",2,1,0,2,1,3,5,6,1,1,4,9,1,9,6,11,21,44,65,13,7,20,10.7692307692308,67.6923076923077,32.3076923076923
"271","46","1",5,6,12,3,8,27,7,7,6,9,24,11,7,8,7,5,77,78,155,10,51,6.45161290322581,32.9032258064516,50.3225806451613,49.6774193548387
"272","46","2",8,10,10,5,10,32,7,3,10,5,33,5,5,5,3,1,87,68,155,9,65,5.80645161290323,41.9354838709677,43.8709677419355,56.1290322580645
"273","46","3",14,9,10,8,12,22,10,5,9,9,24,8,5,10,5,8,91,80,171,22,46,12.8654970760234,26.9005847953216,46.7836257309942,53.2163742690058
"274","46","4",4,7,11,7,11,15,9,9,7,11,15,12,7,12,10,3,74,79,153,7,30,4.57516339869281,19.6078431372549,51.6339869281046,48.3660130718954
"275","46","5",3,5,7,6,4,13,10,10,5,8,10,14,9,12,11,7,59,78,137,10,23,7.2992700729927,16.7883211678832,56.9343065693431,43.0656934306569
"276","46","6",7,10,9,5,8,17,7,5,10,4,16,7,6,5,4,7,68,62,130,14,33,10.7692307692308,25.3846153846154,47.6923076923077,52.3076923076923
"277","47","1",6,10,8,6,9,10,4,8,10,4,10,6,5,6,8,10,62,61,123,16,20,13.0081300813008,16.260162601626,49.5934959349593,50.4065040650407
"278","47","2",0,1,5,3,3,13,6,4,1,7,11,7,5,5,4,7,35,50,85,7,24,8.23529411764706,28.2352941176471,58.8235294117647,41.1764705882353
"279","47","3",0,0,0,2,0,4,3,6,0,2,4,8,2,8,7,37,16,70,86,37,8,43.0232558139535,9.30232558139535,81.3953488372093,18.6046511627907
"280","47","4",0,0,2,3,3,8,3,5,0,5,8,5,2,5,4,10,24,42,66,10,16,15.1515151515152,24.2424242424242,63.6363636363636,36.3636363636364
"281","47","5",0,0,1,1,2,12,2,1,0,2,13,2,0,4,2,1,20,26,46,1,25,2.17391304347826,54.3478260869565,56.5217391304348,43.4782608695652
"282","47","6",0,0,3,3,2,9,6,1,0,6,8,4,4,3,1,4,26,31,57,4,17,7.01754385964912,29.8245614035088,54.3859649122807,45.6140350877193
"283","48","1",11,11,14,9,14,17,11,5,11,12,16,7,10,6,5,2,94,70,164,13,33,7.92682926829268,20.1219512195122,42.6829268292683,57.3170731707317
"284","48","2",9,6,9,4,9,17,2,7,6,7,18,5,4,6,7,11,65,65,130,20,35,15.3846153846154,26.9230769230769,50,50
"285","48","3",1,1,6,7,7,9,9,3,1,12,10,4,6,6,3,4,44,48,92,5,19,5.43478260869565,20.6521739130435,52.1739130434783,47.8260869565217
"286","48","4",0,2,0,6,0,0,5,2,2,3,0,1,6,1,2,2,17,18,35,2,0,5.71428571428571,0,51.4285714285714,48.5714285714286
"287","48","5",2,3,5,1,3,12,3,0,2,3,10,2,2,1,0,0,30,22,52,2,22,3.84615384615385,42.3076923076923,42.3076923076923,57.6923076923077
"288","48","6",0,0,3,2,1,8,3,4,0,5,7,4,4,3,4,6,23,34,57,6,15,10.5263157894737,26.3157894736842,59.6491228070175,40.3508771929825
"289","49","1",7,5,10,7,11,24,9,8,5,12,24,10,6,10,7,3,81,80,161,10,48,6.2111801242236,29.8136645962733,49.6894409937888,50.3105590062112
"290","49","2",0,2,4,1,3,31,4,3,2,3,29,6,2,5,3,5,49,57,106,5,60,4.71698113207547,56.6037735849057,53.7735849056604,46.2264150943396
"291","49","3",0,1,4,2,3,20,5,2,1,5,18,5,3,4,2,1,38,41,79,1,38,1.26582278481013,48.1012658227848,51.8987341772152,48.1012658227848
"292","49","4",0,1,2,3,4,18,6,0,1,4,20,3,1,5,0,0,36,35,71,0,38,0,53.5211267605634,49.2957746478873,50.7042253521127
"293","49","5",0,0,4,0,2,27,5,0,0,4,25,5,2,3,0,0,39,41,80,0,52,0,65,51.25,48.75
"294","49","6",0,0,4,2,2,20,5,0,0,6,18,3,4,1,0,0,35,33,68,0,38,0,55.8823529411765,48.5294117647059,51.4705882352941
"295","5","1",3,8,8,8,10,24,7,11,8,7,26,10,5,13,11,5,80,87,167,8,50,4.79041916167665,29.940119760479,52.0958083832335,47.9041916167665
"296","5","2",24,6,11,7,13,27,7,3,6,12,29,3,5,5,3,3,100,67,167,27,56,16.1676646706587,33.5329341317365,40.1197604790419,59.8802395209581
"297","5","3",4,2,9,4,1,43,13,0,2,11,35,9,12,1,0,0,77,72,149,4,78,2.68456375838926,52.3489932885906,48.3221476510067,51.6778523489933
"298","5","4",0,0,8,3,3,19,12,0,0,11,14,8,8,3,0,0,46,46,92,0,33,0,35.8695652173913,50,50
"299","5","5",0,0,2,5,5,6,8,1,0,7,9,3,3,6,1,1,29,31,60,1,15,1.66666666666667,25,51.6666666666667,48.3333333333333
"300","5","6",2,2,2,3,2,10,8,6,2,4,10,11,4,10,6,5,37,53,90,7,20,7.77777777777778,22.2222222222222,58.8888888888889,41.1111111111111
"301","50","1",1,1,9,2,10,33,6,1,1,10,34,5,1,6,1,0,64,60,124,1,67,0.806451612903226,54.0322580645161,48.3870967741936,51.6129032258064
"302","50","2",0,0,2,0,1,41,3,0,0,2,40,3,1,2,0,0,48,50,98,0,81,0,82.6530612244898,51.0204081632653,48.9795918367347
"303","50","3",0,0,0,0,0,31,0,0,0,0,31,0,0,0,0,0,33,32,65,0,62,0,95.3846153846154,49.2307692307692,50.7692307692308
"304","50","4",1,3,1,2,3,28,3,0,3,0,31,1,0,3,0,0,43,39,82,1,59,1.21951219512195,71.9512195121951,47.5609756097561,52.4390243902439
"305","50","5",0,0,4,2,6,17,3,0,0,6,19,1,0,3,0,0,34,30,64,0,36,0,56.25,46.875,53.125
"306","50","6",2,1,1,0,1,26,0,2,1,0,26,2,0,2,2,3,35,37,72,5,52,6.94444444444444,72.2222222222222,51.3888888888889,48.6111111111111
"307","51","1",1,6,9,7,10,15,6,5,7,9,16,4,6,5,5,12,62,64,126,13,31,10.3174603174603,24.6031746031746,50.7936507936508,49.2063492063492
"308","51","2",1,3,10,6,9,12,9,2,3,13,12,5,7,5,3,0,54,49,103,1,24,0.970873786407767,23.3009708737864,47.5728155339806,52.4271844660194
"309","51","3",2,3,5,3,6,11,4,3,3,6,12,4,3,5,4,4,39,42,81,6,23,7.40740740740741,28.3950617283951,51.8518518518519,48.1481481481481
"310","51","4",0,1,2,2,5,24,2,1,1,4,26,1,0,3,1,1,39,38,77,1,50,1.2987012987013,64.9350649350649,49.3506493506493,50.6493506493507
"311","51","5",0,1,2,2,1,8,2,1,1,3,7,1,2,1,1,0,18,18,36,0,15,0,41.6666666666667,50,50
"312","51","6",9,3,4,2,5,1,2,0,4,3,2,0,2,1,1,1,29,14,43,10,3,23.2558139534884,6.97674418604651,32.5581395348837,67.4418604651163
"313","52","1",10,7,12,4,10,18,7,2,7,10,16,5,7,2,2,0,72,50,122,10,34,8.19672131147541,27.8688524590164,40.9836065573771,59.0163934426229
"314","52","2",1,2,6,1,6,36,5,0,1,5,37,4,0,5,0,0,59,53,112,1,73,0.892857142857143,65.1785714285714,47.3214285714286,52.6785714285714
"315","52","3",5,3,3,1,3,16,1,0,3,1,16,1,1,0,0,0,33,24,57,5,32,8.7719298245614,56.140350877193,42.1052631578947,57.8947368421053
"316","52","4",0,0,0,0,0,1,0,1,1,0,1,1,1,1,2,0,5,7,12,0,2,0,16.6666666666667,58.3333333333333,41.6666666666667
"317","52","5",0,0,0,0,0,0,0,1,0,0,0,1,0,0,0,0,1,4,5,0,0,0,0,80,20
"318","52","6",0,0,0,0,0,0,0,0,0,1,0,0,1,0,0,0,2,3,5,0,0,0,0,60,40
"319","53","1",1,4,5,9,4,9,12,8,3,10,8,11,9,10,8,3,53,64,117,4,17,3.41880341880342,14.5299145299145,54.7008547008547,45.2991452991453
"320","53","2",1,2,3,1,4,9,2,0,2,3,9,1,1,1,0,0,24,18,42,1,18,2.38095238095238,42.8571428571429,42.8571428571429,57.1428571428571
"321","53","3",1,1,6,5,6,26,8,2,1,10,27,5,4,6,2,0,57,56,113,1,53,0.884955752212389,46.9026548672566,49.5575221238938,50.4424778761062
"322","53","4",1,1,1,3,1,5,5,12,1,3,5,13,3,13,11,30,29,82,111,31,10,27.9279279279279,9.00900900900901,73.8738738738739,26.1261261261261
"323","53","5",0,2,1,2,1,10,2,5,1,1,10,5,1,6,5,13,24,44,68,13,20,19.1176470588235,29.4117647058824,64.7058823529412,35.2941176470588
"324","53","6",0,0,0,0,0,0,0,5,0,0,0,5,0,5,6,44,6,62,68,44,0,64.7058823529412,0,91.1764705882353,8.82352941176471
"325","54","1",2,6,5,6,8,11,11,4,6,5,14,9,3,11,3,3,53,57,110,5,25,4.54545454545455,22.7272727272727,51.8181818181818,48.1818181818182
"326","54","2",3,1,2,2,2,19,3,2,1,3,19,3,2,3,2,7,35,42,77,10,38,12.987012987013,49.3506493506493,54.5454545454545,45.4545454545455
"327","54","3",2,1,1,2,2,17,3,0,1,2,17,1,1,2,0,0,29,26,55,2,34,3.63636363636364,61.8181818181818,47.2727272727273,52.7272727272727
"328","54","4",4,1,2,0,2,22,0,0,1,1,22,0,0,0,0,0,32,26,58,4,44,6.89655172413793,75.8620689655172,44.8275862068966,55.1724137931034
"329","54","5",1,1,1,1,2,2,2,0,1,1,4,0,0,2,0,0,12,9,21,1,6,4.76190476190476,28.5714285714286,42.8571428571429,57.1428571428571
"330","54","6",0,1,1,0,1,19,1,0,1,0,20,1,0,1,0,0,25,24,49,0,39,0,79.5918367346939,48.9795918367347,51.0204081632653
"331","55","1",6,5,9,2,5,13,3,7,5,5,10,8,5,5,7,3,52,49,101,9,23,8.91089108910891,22.7722772277228,48.5148514851485,51.4851485148515
"332","55","2",9,4,6,4,5,12,9,2,4,7,11,7,6,5,2,4,53,47,100,13,23,13,23,47,53
"333","55","3",1,5,4,5,4,5,7,5,5,4,5,7,5,7,6,7,37,48,85,8,10,9.41176470588235,11.7647058823529,56.4705882352941,43.5294117647059
"334","55","4",0,1,1,2,3,2,3,1,1,2,4,2,0,3,1,4,14,19,33,4,6,12.1212121212121,18.1818181818182,57.5757575757576,42.4242424242424
"335","55","5",4,3,4,2,3,5,3,0,3,2,5,1,2,1,0,0,26,15,41,4,10,9.75609756097561,24.390243902439,36.5853658536585,63.4146341463415
"336","55","6",3,2,2,3,2,4,2,2,2,3,4,1,3,1,2,2,21,20,41,5,8,12.1951219512195,19.5121951219512,48.780487804878,51.219512195122
"337","56","1",5,9,12,3,8,57,21,3,9,6,53,21,7,17,3,1,120,118,238,6,110,2.52100840336134,46.218487394958,49.5798319327731,50.4201680672269
"338","56","2",9,10,11,10,12,33,12,10,10,11,34,12,9,13,10,10,108,111,219,19,67,8.67579908675799,30.5936073059361,50.6849315068493,49.3150684931507
"339","56","3",5,4,8,9,11,42,12,11,4,13,45,14,6,17,11,11,104,122,226,16,87,7.07964601769912,38.4955752212389,53.9823008849558,46.0176991150442
"340","56","4",5,6,5,7,2,25,9,9,6,6,22,11,11,7,9,15,70,88,158,20,47,12.6582278481013,29.746835443038,55.6962025316456,44.3037974683544
"341","56","5",0,5,7,7,7,17,5,5,5,9,17,3,7,4,6,4,54,57,111,4,34,3.6036036036036,30.6306306306306,51.3513513513514,48.6486486486486
"342","56","6",6,5,6,5,7,14,11,7,4,6,15,13,3,15,7,10,62,75,137,16,29,11.6788321167883,21.1678832116788,54.7445255474453,45.2554744525547
"343","57","1",5,5,8,4,4,8,4,7,5,7,4,7,8,3,6,10,45,53,98,15,12,15.3061224489796,12.2448979591837,54.0816326530612,45.9183673469388
"344","57","2",5,5,6,5,5,6,5,7,5,6,5,7,6,6,8,17,45,62,107,22,11,20.5607476635514,10.2803738317757,57.9439252336449,42.0560747663551
"345","57","3",0,0,1,2,0,11,10,7,0,3,10,16,3,15,8,19,32,76,108,19,21,17.5925925925926,19.4444444444444,70.3703703703704,29.6296296296296
"346","57","4",0,0,0,0,0,1,4,5,0,0,1,8,0,9,5,52,11,77,88,52,2,59.0909090909091,2.27272727272727,87.5,12.5
"347","57","5",2,1,5,2,6,16,4,1,1,6,16,3,1,3,0,1,37,34,71,3,32,4.22535211267606,45.0704225352113,47.887323943662,52.112676056338
"348","57","6",0,0,0,2,1,5,0,5,0,2,6,3,1,4,5,15,13,39,52,15,11,28.8461538461538,21.1538461538462,75,25
"349","58","1",1,6,5,6,7,26,8,5,5,5,28,7,3,10,5,7,65,72,137,8,54,5.83941605839416,39.4160583941606,52.5547445255474,47.4452554744526
"350","58","2",7,5,11,2,9,16,2,7,6,8,13,7,5,4,7,4,62,54,116,11,29,9.48275862068965,25,46.551724137931,53.448275862069
"351","58","3",0,3,3,2,2,11,5,4,2,2,10,7,2,7,4,7,31,43,74,7,21,9.45945945945946,28.3783783783784,58.1081081081081,41.8918918918919
"352","58","4",1,2,5,3,5,8,6,0,2,6,7,3,3,2,0,0,31,25,56,1,15,1.78571428571429,26.7857142857143,44.6428571428571,55.3571428571429
"353","58","5",0,1,2,0,2,7,0,2,1,1,8,2,0,3,2,1,16,19,35,1,15,2.85714285714286,42.8571428571429,54.2857142857143,45.7142857142857
"354","58","6",0,0,0,0,0,5,1,1,0,0,4,2,0,1,0,0,7,10,17,0,9,0,52.9411764705882,58.8235294117647,41.1764705882353
"355","59","1",4,10,5,13,5,21,16,11,10,8,22,14,12,15,11,8,87,101,188,12,43,6.38297872340426,22.8723404255319,53.7234042553191,46.2765957446809
"356","59","2",11,10,9,10,12,14,7,10,10,9,17,7,8,9,10,8,85,79,164,19,31,11.5853658536585,18.9024390243902,48.1707317073171,51.8292682926829
"357","59","3",8,9,12,12,11,14,12,7,9,15,13,7,12,6,7,3,86,74,160,11,27,6.875,16.875,46.25,53.75
"358","59","4",1,2,9,1,6,72,8,9,2,8,69,16,4,12,8,6,108,128,236,7,141,2.96610169491525,59.7457627118644,54.2372881355932,45.7627118644068
"359","59","5",2,5,8,4,5,15,11,7,5,7,12,14,7,10,6,12,57,76,133,14,27,10.5263157894737,20.3007518796992,57.1428571428571,42.8571428571429
"360","59","6",1,1,5,3,1,46,6,8,1,6,43,11,6,8,8,9,73,93,166,10,89,6.02409638554217,53.6144578313253,56.0240963855422,43.9759036144578
"361","6","1",3,3,6,5,7,31,8,10,3,8,32,13,4,15,10,3,74,90,164,6,63,3.65853658536585,38.4146341463415,54.8780487804878,45.1219512195122
"362","6","2",19,8,15,5,15,28,9,6,8,12,27,10,6,9,6,4,107,83,190,23,55,12.1052631578947,28.9473684210526,43.6842105263158,56.3157894736842
"363","6","3",13,8,9,1,9,18,3,4,8,2,19,6,0,7,4,2,67,49,116,15,37,12.9310344827586,31.8965517241379,42.2413793103448,57.7586206896552
"364","6","4",2,2,4,0,3,19,3,0,2,3,18,3,2,1,0,0,35,30,65,2,37,3.07692307692308,56.9230769230769,46.1538461538462,53.8461538461538
"365","6","5",8,4,3,3,3,2,2,3,3,3,2,2,3,2,3,1,30,20,50,9,4,18,8,40,60
"366","6","6",6,3,1,3,3,1,6,2,3,1,3,4,2,6,2,2,27,24,51,8,4,15.6862745098039,7.84313725490196,47.0588235294118,52.9411764705882
"367","60","1",2,4,6,7,9,11,9,8,4,9,14,10,4,13,8,7,57,71,128,9,25,7.03125,19.53125,55.46875,44.53125
"368","60","2",7,10,15,6,12,15,4,7,10,10,12,5,8,2,6,2,76,58,134,9,27,6.71641791044776,20.1492537313433,43.2835820895522,56.7164179104478
"369","60","3",14,12,10,8,11,24,15,7,12,5,25,14,6,16,7,5,102,92,194,19,49,9.79381443298969,25.2577319587629,47.4226804123711,52.5773195876289
"370","60","4",6,7,6,7,7,11,9,5,7,6,13,7,6,8,5,9,60,62,122,15,24,12.2950819672131,19.672131147541,50.8196721311475,49.1803278688525
"371","60","5",6,5,7,8,9,8,5,8,5,10,10,5,6,7,8,6,57,59,116,12,18,10.3448275862069,15.5172413793103,50.8620689655172,49.1379310344828
"372","60","6",6,10,9,9,11,9,7,4,10,8,11,2,6,4,4,4,66,51,117,10,20,8.54700854700855,17.0940170940171,43.5897435897436,56.4102564102564
"373","61","1",8,4,12,3,12,19,7,3,4,11,19,7,3,7,3,3,70,58,128,11,38,8.59375,29.6875,45.3125,54.6875
"374","61","2",1,3,8,3,10,15,4,1,2,9,17,2,1,4,1,1,47,38,85,2,32,2.35294117647059,37.6470588235294,44.7058823529412,55.2941176470588
"375","61","3",2,5,7,4,6,15,8,6,5,5,15,10,4,10,6,3,55,59,114,5,30,4.3859649122807,26.3157894736842,51.7543859649123,48.2456140350877
"376","61","4",4,6,7,3,6,9,3,4,6,4,7,4,4,3,4,4,43,38,81,8,16,9.87654320987654,19.7530864197531,46.9135802469136,53.0864197530864
"377","61","5",16,3,2,3,4,3,5,1,4,2,5,3,2,5,2,0,40,23,63,16,8,25.3968253968254,12.6984126984127,36.5079365079365,63.4920634920635
"378","61","6",1,2,4,1,2,3,3,1,2,3,2,2,3,1,1,1,19,16,35,2,5,5.71428571428571,14.2857142857143,45.7142857142857,54.2857142857143
"379","62","1",13,5,8,5,11,7,4,1,5,8,10,0,3,2,1,1,56,31,87,14,17,16.0919540229885,19.5402298850575,35.632183908046,64.367816091954
"380","62","2",4,3,10,0,10,9,1,0,3,7,9,1,0,1,0,0,39,22,61,4,18,6.55737704918033,29.5081967213115,36.0655737704918,63.9344262295082
"381","62","3",15,4,3,1,2,0,0,1,3,0,0,0,1,0,1,0,28,6,34,15,0,44.1176470588235,0,17.6470588235294,82.3529411764706
"382","62","4",1,2,2,0,1,3,0,0,2,0,2,0,1,0,0,0,10,7,17,1,5,5.88235294117647,29.4117647058824,41.1764705882353,58.8235294117647
"383","62","5",0,0,1,1,1,0,0,1,0,2,0,0,0,0,0,3,4,8,12,3,0,25,0,66.6666666666667,33.3333333333333
"384","62","6",0,0,0,1,0,0,0,1,0,1,0,0,1,0,0,2,2,7,9,2,0,22.2222222222222,0,77.7777777777778,22.2222222222222
"385","63","1",4,5,10,3,6,25,11,11,5,8,21,19,7,14,11,16,76,103,179,20,46,11.1731843575419,25.6983240223464,57.5418994413408,42.4581005586592
"386","63","2",6,5,11,9,9,19,6,12,5,15,17,10,11,7,12,12,78,91,169,18,36,10.6508875739645,21.301775147929,53.8461538461538,46.1538461538462
"387","63","3",2,4,6,1,3,23,11,6,4,3,20,16,4,13,6,9,58,76,134,11,43,8.2089552238806,32.089552238806,56.7164179104478,43.2835820895522
"388","63","4",1,1,0,5,1,7,7,0,1,4,9,2,3,4,0,0,24,24,48,1,16,2.08333333333333,33.3333333333333,50,50
"389","63","5",2,1,2,0,2,30,3,0,1,1,31,3,0,3,0,0,42,40,82,2,61,2.4390243902439,74.390243902439,48.780487804878,51.219512195122
"390","63","6",3,2,1,1,2,17,2,0,2,0,18,1,0,2,0,0,29,25,54,3,35,5.55555555555556,64.8148148148148,46.2962962962963,53.7037037037037
"391","64","1",8,8,11,6,12,23,6,6,8,9,24,6,5,6,5,1,80,67,147,9,47,6.12244897959184,31.9727891156463,45.578231292517,54.421768707483
"392","64","2",11,8,9,4,11,17,5,4,8,5,19,5,2,7,4,2,70,54,124,13,36,10.4838709677419,29.0322580645161,43.5483870967742,56.4516129032258
"393","64","3",5,5,9,2,8,13,4,3,5,6,12,5,3,4,3,8,50,48,98,13,25,13.265306122449,25.5102040816327,48.9795918367347,51.0204081632653
"394","64","4",0,0,2,1,2,15,7,3,0,3,15,9,1,8,3,3,31,44,75,3,30,4,40,58.6666666666667,41.3333333333333
"395","64","5",4,2,6,2,5,22,7,3,2,6,21,8,3,8,3,3,52,56,108,7,43,6.48148148148148,39.8148148148148,51.8518518518519,48.1481481481481
"396","64","6",1,3,6,4,7,23,8,0,3,7,25,3,3,5,0,0,54,47,101,1,48,0.99009900990099,47.5247524752475,46.5346534653465,53.4653465346535
"397","65","1",9,9,9,1,7,23,3,4,9,1,21,6,3,4,4,5,67,54,121,14,44,11.5702479338843,36.3636363636364,44.6280991735537,55.3719008264463
"398","65","2",3,4,7,1,6,21,4,4,4,5,20,7,3,5,4,4,52,53,105,7,41,6.66666666666667,39.0476190476191,50.4761904761905,49.5238095238095
"399","65","3",8,4,2,5,3,5,6,1,5,3,6,2,4,3,1,1,37,25,62,9,11,14.5161290322581,17.741935483871,40.3225806451613,59.6774193548387
"400","65","4",5,4,7,7,8,8,8,4,4,11,9,4,7,5,4,4,53,49,102,9,17,8.82352941176471,16.6666666666667,48.0392156862745,51.9607843137255
"401","65","5",2,3,2,4,4,8,7,11,3,3,9,14,2,15,10,36,41,95,136,38,17,27.9411764705882,12.5,69.8529411764706,30.1470588235294
"402","65","6",0,0,1,3,0,2,2,10,0,4,2,9,4,9,11,100,20,140,160,100,4,62.5,2.5,87.5,12.5
"403","66","1",7,7,8,9,9,16,12,7,7,10,17,10,8,11,6,8,75,80,155,15,33,9.67741935483871,21.2903225806452,51.6129032258064,48.3870967741936
"404","66","2",2,2,3,1,2,17,2,3,2,2,17,4,2,3,3,3,34,37,71,5,34,7.04225352112676,47.887323943662,52.112676056338,47.887323943662
"405","66","3",2,2,4,1,5,27,2,2,2,3,28,3,1,3,2,6,47,49,96,8,55,8.33333333333333,57.2916666666667,51.0416666666667,48.9583333333333
"406","66","4",10,4,6,8,8,9,7,5,4,10,11,5,6,7,5,5,58,55,113,15,20,13.2743362831858,17.6991150442478,48.6725663716814,51.3274336283186
"407","66","5",3,2,1,2,1,13,3,3,2,1,13,4,2,4,3,3,29,34,63,6,26,9.52380952380952,41.2698412698413,53.968253968254,46.031746031746
"408","66","6",11,5,8,3,8,6,2,1,4,6,6,1,2,1,1,0,45,23,68,11,12,16.1764705882353,17.6470588235294,33.8235294117647,66.1764705882353
"409","67","1",9,10,5,12,10,15,12,7,9,7,20,7,7,12,7,11,82,81,163,20,35,12.2699386503067,21.4723926380368,49.6932515337423,50.3067484662577
"410","67","2",7,10,16,4,17,8,3,2,11,10,9,1,3,2,2,0,70,38,108,7,17,6.48148148148148,15.7407407407407,35.1851851851852,64.8148148148148
"411","67","3",6,7,15,3,14,10,5,0,7,11,10,2,4,2,0,0,62,37,99,6,20,6.06060606060606,20.2020202020202,37.3737373737374,62.6262626262626
"412","67","4",4,2,10,1,8,21,5,0,2,10,19,4,4,1,0,0,53,41,94,4,40,4.25531914893617,42.5531914893617,43.6170212765957,56.3829787234043
"413","67","5",4,1,2,2,1,11,5,1,1,3,11,3,3,3,1,0,29,26,55,4,22,7.27272727272727,40,47.2727272727273,52.7272727272727
"414","67","6",0,0,0,0,0,15,1,0,0,0,14,1,0,1,0,0,17,18,35,0,29,0,82.8571428571429,51.4285714285714,48.5714285714286
"415","68","1",24,8,14,6,12,18,7,7,8,13,16,8,9,5,7,4,98,71,169,28,34,16.5680473372781,20.1183431952663,42.0118343195266,57.9881656804734
"416","68","2",1,7,9,7,6,19,20,6,7,9,16,19,9,16,6,2,76,86,162,3,35,1.85185185185185,21.6049382716049,53.0864197530864,46.9135802469136
"417","68","3",7,11,11,4,9,12,3,3,11,4,10,2,5,1,3,1,61,39,100,8,22,8,22,39,61
"418","68","4",1,1,3,0,1,15,3,1,1,2,12,4,3,1,1,0,27,25,52,1,27,1.92307692307692,51.9230769230769,48.0769230769231,51.9230769230769
"419","68","5",0,1,3,1,1,8,3,1,1,3,6,3,2,1,0,0,18,19,37,0,14,0,37.8378378378378,51.3513513513514,48.6486486486486
"420","68","6",0,3,3,2,2,6,3,5,3,2,5,6,3,4,5,8,25,38,63,8,11,12.6984126984127,17.4603174603175,60.3174603174603,39.6825396825397
"421","69","1",12,6,8,8,12,24,16,3,6,10,28,11,4,15,3,0,90,79,169,12,52,7.10059171597633,30.7692307692308,46.7455621301775,53.2544378698225
"422","69","2",1,3,7,3,7,24,11,2,4,7,24,10,4,10,2,0,61,61,122,1,48,0.819672131147541,39.344262295082,50,50
"423","69","3",9,8,10,7,6,21,8,9,8,9,17,10,11,6,9,10,79,82,161,19,38,11.8012422360248,23.6024844720497,50.9316770186335,49.0683229813665
"424","69","4",3,2,5,6,6,22,14,6,2,9,23,13,5,14,5,10,64,84,148,13,45,8.78378378378378,30.4054054054054,56.7567567567568,43.2432432432432
"425","69","5",1,1,15,12,13,32,23,3,1,26,31,14,14,12,3,6,102,108,210,7,63,3.33333333333333,30,51.4285714285714,48.5714285714286
"426","69","6",1,2,6,9,6,29,17,8,2,14,29,16,10,16,9,8,80,105,185,9,58,4.86486486486486,31.3513513513514,56.7567567567568,43.2432432432432
"427","7","1",5,3,6,5,6,10,5,8,3,8,11,8,4,9,8,9,50,61,111,14,21,12.6126126126126,18.9189189189189,54.954954954955,45.045045045045
"428","7","2",5,2,2,3,1,9,5,4,2,3,8,6,4,6,4,2,32,37,69,7,17,10.1449275362319,24.6376811594203,53.6231884057971,46.3768115942029
"429","7","3",0,0,0,3,1,7,2,1,0,3,9,0,2,1,1,1,16,18,34,1,16,2.94117647058824,47.0588235294118,52.9411764705882,47.0588235294118
"430","7","4",0,0,0,0,0,24,0,0,0,0,25,0,0,0,0,0,26,26,52,0,49,0,94.2307692307692,50,50
"431","7","5",28,11,15,0,14,32,1,1,11,4,32,2,1,1,1,0,104,53,157,28,64,17.8343949044586,40.7643312101911,33.7579617834395,66.2420382165605
"432","7","6",30,15,15,5,12,10,8,2,15,5,6,5,9,1,2,0,99,44,143,30,16,20.979020979021,11.1888111888112,30.7692307692308,69.2307692307692
"433","70","1",28,9,6,6,10,5,6,0,10,3,9,0,3,3,0,0,73,28,101,28,14,27.7227722772277,13.8613861386139,27.7227722772277,72.2772277227723
"434","70","2",17,8,13,2,13,3,2,2,9,6,3,2,2,2,2,3,63,29,92,20,6,21.7391304347826,6.52173913043478,31.5217391304348,68.4782608695652
"435","70","3",16,6,8,1,7,4,3,1,7,3,3,2,3,1,1,0,49,20,69,16,7,23.1884057971014,10.1449275362319,28.9855072463768,71.0144927536232
"436","70","4",13,4,5,0,5,3,0,0,4,1,3,0,0,0,0,0,32,9,41,13,6,31.7073170731707,14.6341463414634,21.9512195121951,78.0487804878049
"437","70","5",11,4,4,1,3,1,2,0,4,1,0,1,2,0,0,0,29,8,37,11,1,29.7297297297297,2.7027027027027,21.6216216216216,78.3783783783784
"438","70","6",2,1,2,1,3,2,2,0,2,2,3,1,1,1,0,0,16,10,26,2,5,7.69230769230769,19.2307692307692,38.4615384615385,61.5384615384615
"439","71","1",17,14,20,6,19,22,9,7,14,11,22,10,6,10,7,6,116,87,203,23,44,11.3300492610837,21.6748768472906,42.8571428571429,57.1428571428571
"440","71","2",22,12,11,7,11,20,3,6,12,6,20,2,7,2,6,4,95,59,154,26,40,16.8831168831169,25.974025974026,38.3116883116883,61.6883116883117
"441","71","3",7,14,12,6,12,19,13,3,13,4,19,10,5,11,3,1,87,68,155,8,38,5.16129032258065,24.5161290322581,43.8709677419355,56.1290322580645
"442","71","4",33,10,16,6,14,38,11,5,11,12,36,10,9,7,5,1,136,91,227,34,74,14.9779735682819,32.5991189427313,40.0881057268723,59.9118942731277
"443","71","5",152,20,23,1,23,14,0,1,20,4,14,0,1,0,1,0,237,40,277,152,28,54.8736462093863,10.1083032490975,14.4404332129964,85.5595667870036
"444","71","6",145,20,20,0,20,29,0,0,20,0,29,0,0,0,0,0,237,49,286,145,58,50.6993006993007,20.2797202797203,17.1328671328671,82.8671328671329
"445","72","1",6,10,14,6,14,26,8,8,10,10,27,9,6,10,8,4,94,85,179,10,53,5.58659217877095,29.608938547486,47.4860335195531,52.5139664804469
"446","72","2",0,1,5,4,7,20,8,2,1,8,22,6,2,8,2,0,48,51,99,0,42,0,42.4242424242424,51.5151515151515,48.4848484848485
"447","72","3",0,1,5,1,5,17,4,1,1,5,17,3,1,4,1,0,35,34,69,0,34,0,49.2753623188406,49.2753623188406,50.7246376811594
"448","72","4",0,0,4,2,1,20,5,1,0,6,16,4,5,1,1,0,34,35,69,0,36,0,52.1739130434783,50.7246376811594,49.2753623188406
"449","72","5",0,0,2,2,2,18,5,1,0,5,17,4,3,3,1,1,32,35,67,1,35,1.49253731343284,52.2388059701493,52.2388059701493,47.7611940298507
"450","72","6",0,1,11,3,14,21,4,1,1,14,24,2,0,5,1,0,57,48,105,0,45,0,42.8571428571429,45.7142857142857,54.2857142857143
"451","73","1",11,8,13,7,13,23,12,3,8,12,23,8,7,8,3,7,91,78,169,18,46,10.6508875739645,27.2189349112426,46.1538461538462,53.8461538461538
"452","73","2",0,1,5,3,7,10,6,0,1,7,12,3,1,5,0,0,34,30,64,0,22,0,34.375,46.875,53.125
"453","73","3",0,1,2,2,3,13,6,0,1,4,13,4,2,4,0,0,29,29,58,0,26,0,44.8275862068966,50,50
"454","73","4",0,0,4,0,3,7,4,0,0,4,6,3,1,3,0,0,19,19,38,0,13,0,34.2105263157895,50,50
"455","73","5",0,0,1,0,1,8,2,0,0,1,8,2,0,2,0,0,14,14,28,0,16,0,57.1428571428571,50,50
"456","73","6",1,1,3,1,2,9,3,1,1,3,8,3,1,2,1,0,22,21,43,1,17,2.32558139534884,39.5348837209302,48.8372093023256,51.1627906976744
"457","74","1",7,7,8,7,8,9,8,4,7,7,9,5,6,6,4,4,59,50,109,11,18,10.0917431192661,16.5137614678899,45.8715596330275,54.1284403669725
"458","74","2",3,4,5,3,6,20,6,1,3,5,21,4,2,5,1,0,50,42,92,3,41,3.26086956521739,44.5652173913044,45.6521739130435,54.3478260869565
"459","74","3",37,17,15,6,16,23,7,2,18,4,23,3,6,3,2,0,126,59,185,37,46,20,24.8648648648649,31.8918918918919,68.1081081081081
"460","74","4",20,10,12,3,11,14,5,5,9,6,13,7,4,6,5,3,82,54,136,23,27,16.9117647058824,19.8529411764706,39.7058823529412,60.2941176470588
"461","74","5",2,4,3,4,1,4,4,4,4,3,3,3,6,2,4,5,28,31,59,7,7,11.864406779661,11.864406779661,52.5423728813559,47.4576271186441
"462","74","6",4,4,2,4,4,13,2,3,4,2,15,2,2,4,4,5,37,40,77,9,28,11.6883116883117,36.3636363636364,51.9480519480519,48.0519480519481
"463","75","1",10,4,5,8,9,5,5,5,5,9,9,2,5,6,6,4,54,46,100,14,14,14,14,46,54
"464","75","2",0,0,2,3,3,4,4,1,0,6,5,1,3,2,1,0,19,19,38,0,9,0,23.6842105263158,50,50
"465","75","3",0,1,6,1,6,22,5,0,1,6,22,4,1,3,0,0,42,39,81,0,44,0,54.320987654321,48.1481481481481,51.8518518518519
"466","75","4",68,10,7,6,11,6,7,1,11,3,10,2,3,5,1,0,119,35,154,68,16,44.1558441558442,10.3896103896104,22.7272727272727,77.2727272727273
"467","75","5",150,8,6,2,6,1,2,0,7,0,1,0,1,1,0,0,176,12,188,150,2,79.7872340425532,1.06382978723404,6.38297872340426,93.6170212765958
"468","75","6",0,4,4,3,6,25,5,2,4,3,26,4,2,5,2,1,51,48,99,1,51,1.01010101010101,51.5151515151515,48.4848484848485,51.5151515151515
"469","76","1",4,4,11,4,12,9,6,2,4,11,10,4,3,5,2,1,54,41,95,5,19,5.26315789473684,20,43.1578947368421,56.8421052631579
"470","76","2",12,4,4,3,4,3,1,3,5,3,3,1,3,1,3,0,37,19,56,12,6,21.4285714285714,10.7142857142857,33.9285714285714,66.0714285714286
"471","76","3",2,2,0,3,0,0,3,1,2,0,0,1,2,1,1,0,12,9,21,2,0,9.52380952380952,0,42.8571428571429,57.1428571428571
"472","76","4",3,4,5,2,6,1,1,2,4,4,2,1,2,1,2,1,26,18,44,4,3,9.09090909090909,6.81818181818182,40.9090909090909,59.0909090909091
"473","76","5",6,3,3,1,3,5,0,0,3,1,5,0,0,0,0,0,22,11,33,6,10,18.1818181818182,30.3030303030303,33.3333333333333,66.6666666666667
"474","76","6",1,1,2,0,1,8,1,0,1,1,7,1,1,1,0,0,15,14,29,1,15,3.44827586206897,51.7241379310345,48.2758620689655,51.7241379310345
"475","77","1",3,7,12,8,10,16,10,11,7,13,14,14,10,11,11,15,78,97,175,18,30,10.2857142857143,17.1428571428571,55.4285714285714,44.5714285714286
"476","77","2",3,3,5,4,5,10,8,13,3,6,10,17,4,17,12,22,51,94,145,25,20,17.2413793103448,13.7931034482759,64.8275862068966,35.1724137931034
"477","77","3",0,3,6,5,5,12,7,11,3,9,11,13,6,12,11,11,51,77,128,11,23,8.59375,17.96875,60.15625,39.84375
"478","77","4",1,4,8,9,13,6,8,7,4,13,11,6,5,10,7,13,58,70,128,14,17,10.9375,13.28125,54.6875,45.3125
"479","77","5",0,2,6,6,7,5,3,11,2,9,7,8,4,10,11,8,42,60,102,8,12,7.84313725490196,11.7647058823529,58.8235294117647,41.1764705882353
"480","77","6",4,6,8,6,9,8,11,6,6,8,9,11,5,12,6,1,60,59,119,5,17,4.20168067226891,14.2857142857143,49.5798319327731,50.4201680672269
"481","78","1",7,1,3,3,3,50,5,5,1,5,50,7,3,8,5,2,78,83,161,9,100,5.59006211180124,62.111801242236,51.5527950310559,48.4472049689441
"482","78","2",2,3,4,1,4,95,2,0,3,2,96,0,1,1,0,0,113,104,217,2,191,0.921658986175115,88.0184331797235,47.926267281106,52.073732718894
"483","78","3",4,1,5,1,3,35,4,1,1,5,33,4,2,3,1,2,55,53,108,6,68,5.55555555555556,62.962962962963,49.0740740740741,50.9259259259259
"484","78","4",1,2,3,0,2,30,2,4,2,1,29,6,1,5,4,17,46,66,112,18,59,16.0714285714286,52.6785714285714,58.9285714285714,41.0714285714286
"485","78","5",0,0,0,0,0,25,2,2,0,0,26,4,0,4,2,4,31,41,72,4,51,5.55555555555556,70.8333333333333,56.9444444444444,43.0555555555556
"486","78","6",1,1,6,0,4,14,2,1,1,5,13,3,2,1,1,2,31,29,60,3,27,5,45,48.3333333333333,51.6666666666667
"487","79","1",7,6,9,4,9,22,10,6,6,7,22,13,4,12,6,2,74,74,148,9,44,6.08108108108108,29.7297297297297,50,50
"488","79","2",10,10,14,7,15,12,9,3,10,11,12,5,6,5,2,1,80,55,135,11,24,8.14814814814815,17.7777777777778,40.7407407407407,59.2592592592593
"489","79","3",3,1,4,2,3,12,4,1,1,5,12,3,3,3,1,1,32,30,62,4,24,6.45161290322581,38.7096774193548,48.3870967741936,51.6129032258064
"490","79","4",2,2,2,0,2,32,0,0,2,0,32,0,0,0,0,0,41,36,77,2,64,2.5974025974026,83.1168831168831,46.7532467532468,53.2467532467532
"491","79","5",0,0,3,0,1,33,3,0,0,3,31,3,2,1,0,0,42,41,83,0,64,0,77.1084337349398,49.3975903614458,50.6024096385542
"492","79","6",0,2,5,5,4,41,9,3,2,8,40,7,6,6,3,4,71,77,148,4,81,2.7027027027027,54.7297297297297,52.027027027027,47.972972972973
"493","8","1",15,6,10,6,5,10,7,9,6,9,5,10,10,5,8,9,68,65,133,24,15,18.0451127819549,11.2781954887218,48.8721804511278,51.1278195488722
"494","8","2",4,6,6,7,4,7,5,8,6,7,5,6,9,4,7,23,47,70,117,27,12,23.0769230769231,10.2564102564103,59.8290598290598,40.1709401709402
"495","8","3",0,2,1,1,2,6,0,8,2,0,7,7,0,8,8,19,20,54,74,19,13,25.6756756756757,17.5675675675676,72.972972972973,27.027027027027
"496","8","4",3,2,4,1,2,6,4,4,2,3,4,7,2,5,3,1,26,30,56,4,10,7.14285714285714,17.8571428571429,53.5714285714286,46.4285714285714
"497","8","5",5,2,1,2,2,1,0,2,2,1,1,1,1,1,2,2,16,13,29,7,2,24.1379310344828,6.89655172413793,44.8275862068966,55.1724137931034
"498","8","6",6,3,3,1,3,2,1,1,4,1,1,1,2,0,1,0,23,10,33,6,3,18.1818181818182,9.09090909090909,30.3030303030303,69.6969696969697
"499","80","1",11,10,9,6,8,7,5,5,10,5,7,4,6,4,5,6,63,48,111,17,14,15.3153153153153,12.6126126126126,43.2432432432432,56.7567567567568
"500","80","2",6,5,6,9,6,10,12,5,5,9,10,8,8,8,5,6,60,61,121,12,20,9.91735537190083,16.5289256198347,50.4132231404959,49.5867768595041
"501","80","3",3,3,6,4,6,18,7,3,3,7,18,6,3,6,2,3,50,51,101,6,36,5.94059405940594,35.6435643564356,50.4950495049505,49.5049504950495
"502","80","4",0,2,5,3,3,4,3,6,2,6,2,6,5,4,6,10,28,42,70,10,6,14.2857142857143,8.57142857142857,60,40
"503","80","5",2,5,6,2,5,4,4,6,5,3,3,7,3,6,6,9,35,44,79,11,7,13.9240506329114,8.86075949367089,55.6962025316456,44.3037974683544
"504","80","6",1,2,1,2,0,2,2,8,2,1,2,8,3,8,8,12,20,45,65,13,4,20,6.15384615384615,69.2307692307692,30.7692307692308
"505","81","1",13,4,7,5,7,17,6,2,4,8,18,3,4,4,2,1,63,45,108,14,35,12.962962962963,32.4074074074074,41.6666666666667,58.3333333333333
"506","81","2",1,5,5,5,6,13,11,2,5,5,15,8,4,9,2,4,50,53,103,5,28,4.85436893203883,27.1844660194175,51.4563106796116,48.5436893203884
"507","81","3",6,5,8,4,9,12,11,0,5,8,13,7,4,7,0,0,57,45,102,6,25,5.88235294117647,24.5098039215686,44.1176470588235,55.8823529411765
"508","81","4",2,3,10,3,6,29,9,1,3,10,25,6,7,2,0,0,63,56,119,2,54,1.68067226890756,45.3781512605042,47.0588235294118,52.9411764705882
"509","81","5",11,5,5,0,5,32,1,0,5,0,33,0,0,1,0,0,61,40,101,11,65,10.8910891089109,64.3564356435644,39.6039603960396,60.3960396039604
"510","81","6",12,7,9,1,7,17,2,0,7,3,15,1,2,0,0,0,56,30,86,12,32,13.953488372093,37.2093023255814,34.8837209302326,65.1162790697674
"511","82","1",1,2,5,2,3,31,6,6,2,5,29,10,4,9,7,5,57,73,130,6,60,4.61538461538461,46.1538461538462,56.1538461538462,43.8461538461538
"512","82","2",1,1,3,1,0,39,8,4,1,3,35,12,4,8,4,1,58,70,128,2,74,1.5625,57.8125,54.6875,45.3125
"513","82","3",1,2,6,1,5,24,5,4,2,5,22,8,2,7,4,7,49,59,108,8,46,7.40740740740741,42.5925925925926,54.6296296296296,45.3703703703704
"514","82","4",1,2,4,2,3,11,2,8,2,4,10,8,3,7,8,4,34,48,82,5,21,6.09756097560976,25.609756097561,58.5365853658537,41.4634146341463
"515","82","5",0,1,0,2,3,17,4,3,1,1,20,5,0,8,3,4,32,43,75,4,37,5.33333333333333,49.3333333333333,57.3333333333333,42.6666666666667
"516","82","6",0,0,3,2,0,21,3,6,0,4,18,7,4,4,6,10,36,55,91,10,39,10.989010989011,42.8571428571429,60.4395604395604,39.5604395604396
"517","83","1",3,3,7,5,9,26,5,13,3,8,28,13,3,15,13,16,73,100,173,19,54,10.9826589595376,31.2138728323699,57.8034682080925,42.1965317919075
"518","83","2",9,7,7,8,6,15,11,9,7,8,14,12,10,11,10,17,74,90,164,26,29,15.8536585365854,17.6829268292683,54.8780487804878,45.1219512195122
"519","83","3",9,5,5,5,7,22,6,7,5,5,24,8,3,10,7,3,68,66,134,12,46,8.95522388059701,34.3283582089552,49.2537313432836,50.7462686567164
"520","83","4",26,8,7,4,9,7,3,1,8,3,8,0,2,2,1,2,66,28,94,28,15,29.7872340425532,15.9574468085106,29.7872340425532,70.2127659574468
"521","83","5",17,3,4,1,3,2,1,1,3,1,1,1,2,0,1,0,34,10,44,17,3,38.6363636363636,6.81818181818182,22.7272727272727,77.2727272727273
"522","83","6",2,2,2,3,2,7,1,3,2,3,7,2,3,2,3,2,23,26,49,4,14,8.16326530612245,28.5714285714286,53.0612244897959,46.9387755102041
"523","84","1",2,5,3,6,3,2,6,6,5,4,2,7,6,7,6,10,34,49,83,12,4,14.4578313253012,4.81927710843374,59.0361445783133,40.9638554216867
"524","84","2",1,4,2,3,3,8,4,3,4,2,9,4,3,4,3,2,30,32,62,3,17,4.83870967741935,27.4193548387097,51.6129032258064,48.3870967741936
"525","84","3",1,5,6,3,7,5,4,5,4,4,6,7,1,8,5,3,37,40,77,4,11,5.19480519480519,14.2857142857143,51.9480519480519,48.0519480519481
"526","84","4",2,2,1,5,2,12,4,4,2,3,14,3,3,5,4,4,34,39,73,6,26,8.21917808219178,35.6164383561644,53.4246575342466,46.5753424657534
"527","84","5",1,2,4,3,3,9,6,6,2,5,9,9,4,8,6,4,36,48,84,5,18,5.95238095238095,21.4285714285714,57.1428571428571,42.8571428571429
"528","84","6",3,6,3,5,4,7,10,5,6,2,8,9,4,11,5,10,44,57,101,13,15,12.8712871287129,14.8514851485149,56.4356435643564,43.5643564356436
"529","85","1",2,7,12,8,11,10,15,9,7,13,9,16,8,16,9,8,75,88,163,10,19,6.13496932515337,11.6564417177914,53.9877300613497,46.0122699386503
"530","85","2",12,10,14,3,13,25,8,3,10,7,23,8,5,6,3,3,90,66,156,15,48,9.61538461538461,30.7692307692308,42.3076923076923,57.6923076923077
"531","85","3",48,10,7,4,7,8,4,1,10,1,8,1,4,1,1,0,92,26,118,48,16,40.6779661016949,13.5593220338983,22.0338983050847,77.9661016949153
"532","85","4",35,5,5,2,4,3,3,0,4,2,3,1,2,1,0,0,59,14,73,35,6,47.9452054794521,8.21917808219178,19.1780821917808,80.8219178082192
"533","85","5",7,2,4,0,1,2,1,1,2,2,0,2,2,0,1,2,20,12,32,9,2,28.125,6.25,37.5,62.5
"534","85","6",0,0,1,1,1,4,2,2,0,2,4,3,1,3,3,6,12,24,36,6,8,16.6666666666667,22.2222222222222,66.6666666666667,33.3333333333333
"535","86","1",0,4,2,3,4,6,4,3,4,1,8,4,1,6,3,5,27,34,61,5,14,8.19672131147541,22.9508196721311,55.7377049180328,44.2622950819672
"536","86","2",0,0,0,0,0,0,0,0,0,0,0,0,0,0,0,0,0,0,0,0,0,NA,NA,NA,NA
"537","86","3",0,0,0,0,0,0,2,0,0,0,0,1,0,2,0,0,3,5,8,0,0,0,0,62.5,37.5
"538","86","4",2,1,1,2,1,0,3,2,1,1,1,3,1,4,2,3,14,17,31,5,1,16.1290322580645,3.2258064516129,54.8387096774194,45.1612903225806
"539","86","5",3,2,0,2,0,0,2,0,1,0,1,0,1,1,0,0,11,5,16,3,1,18.75,6.25,31.25,68.75
"540","86","6",0,1,1,0,0,1,0,0,0,0,0,0,0,0,0,0,4,2,6,0,1,0,16.6666666666667,33.3333333333333,66.6666666666667
"541","87","1",9,9,11,6,10,17,12,7,9,8,16,13,7,13,7,4,82,79,161,13,33,8.07453416149068,20.4968944099379,49.0683229813665,50.9316770186335
"542","87","2",0,2,9,3,9,22,5,2,2,10,22,3,4,3,2,4,54,51,105,4,44,3.80952380952381,41.9047619047619,48.5714285714286,51.4285714285714
"543","87","3",4,5,4,6,4,13,10,6,5,5,13,10,6,10,5,4,52,61,113,8,26,7.07964601769912,23.0088495575221,53.9823008849558,46.0176991150442
"544","87","4",1,7,13,4,12,23,7,0,7,10,22,3,4,3,0,0,68,51,119,1,45,0.840336134453782,37.8151260504202,42.8571428571429,57.1428571428571
"545","87","5",13,10,14,2,13,17,4,4,10,7,16,5,4,4,4,0,79,51,130,13,33,10,25.3846153846154,39.2307692307692,60.7692307692308
"546","87","6",13,13,20,1,20,6,1,0,14,8,6,0,1,0,0,0,77,29,106,13,12,12.2641509433962,11.3207547169811,27.3584905660377,72.6415094339623
"547","88","1",0,6,6,12,3,7,7,19,6,11,4,14,14,11,18,62,60,143,203,62,11,30.5418719211823,5.41871921182266,70.4433497536946,29.5566502463054
"548","88","2",8,7,13,13,13,17,6,24,7,18,17,18,12,18,24,61,102,177,279,69,34,24.7311827956989,12.1863799283154,63.4408602150538,36.5591397849462
"549","88","3",8,10,13,9,15,16,4,14,10,12,18,9,6,11,13,27,89,109,198,35,34,17.6767676767677,17.1717171717172,55.0505050505051,44.9494949494949
"550","88","4",6,8,12,9,7,14,15,15,8,13,10,20,14,16,15,12,88,109,197,18,24,9.13705583756345,12.1827411167513,55.3299492385787,44.6700507614213
"551","88","5",4,4,7,5,6,13,19,12,4,8,12,25,7,24,12,19,72,112,184,23,25,12.5,13.5869565217391,60.8695652173913,39.1304347826087
"552","88","6",4,8,7,9,9,13,11,17,8,8,16,18,7,21,17,18,80,114,194,22,29,11.340206185567,14.9484536082474,58.7628865979381,41.2371134020619
"553","89","1",1,2,4,7,5,26,6,10,2,9,27,9,6,10,10,12,62,87,149,13,53,8.7248322147651,35.5704697986577,58.3892617449664,41.6107382550336
"554","89","2",0,1,0,2,2,9,7,0,1,2,10,5,1,6,0,0,23,26,49,0,19,0,38.7755102040816,53.0612244897959,46.9387755102041
"555","89","3",0,0,0,1,1,19,1,0,0,1,20,0,0,1,0,0,24,23,47,0,39,0,82.9787234042553,48.936170212766,51.063829787234
"556","89","4",0,1,2,1,3,14,1,0,1,2,16,0,0,1,0,0,24,21,45,0,30,0,66.6666666666667,46.6666666666667,53.3333333333333
"557","89","5",0,0,2,0,2,15,2,0,0,2,15,2,0,2,0,0,22,23,45,0,30,0,66.6666666666667,51.1111111111111,48.8888888888889
"558","89","6",5,6,7,11,7,33,23,3,6,12,33,15,10,16,3,1,96,98,194,6,66,3.09278350515464,34.020618556701,50.5154639175258,49.4845360824742
"559","9","1",13,12,10,9,9,9,8,7,11,7,8,7,9,6,7,7,78,64,142,20,17,14.0845070422535,11.9718309859155,45.0704225352113,54.9295774647887
"560","9","2",6,11,13,4,14,14,7,3,11,6,14,6,4,6,3,1,74,52,126,7,28,5.55555555555556,22.2222222222222,41.2698412698413,58.7301587301587
"561","9","3",13,6,4,7,6,7,9,4,6,5,9,6,5,7,4,1,57,45,102,14,16,13.7254901960784,15.6862745098039,44.1176470588235,55.8823529411765
"562","9","4",25,8,9,2,8,10,3,0,7,3,10,1,2,1,0,0,67,25,92,25,20,27.1739130434783,21.7391304347826,27.1739130434783,72.8260869565217
"563","9","5",3,2,2,0,2,6,2,0,3,0,6,1,1,1,0,0,20,12,32,3,12,9.375,37.5,37.5,62.5
"564","9","6",9,2,3,0,3,4,0,0,2,1,4,0,0,0,0,0,23,8,31,9,8,29.0322580645161,25.8064516129032,25.8064516129032,74.1935483870968
"565","90","1",3,3,8,4,9,29,9,5,3,9,30,9,3,11,5,7,71,79,150,10,59,6.66666666666667,39.3333333333333,52.6666666666667,47.3333333333333
"566","90","2",0,1,2,2,2,16,4,2,0,3,16,4,1,5,2,2,30,35,65,2,32,3.07692307692308,49.2307692307692,53.8461538461538,46.1538461538462
"567","90","3",0,1,9,1,8,12,2,0,1,9,12,1,1,1,0,0,35,26,61,0,24,0,39.344262295082,42.6229508196721,57.3770491803279
"568","90","4",1,1,2,0,2,15,2,0,1,1,14,2,0,2,0,0,24,22,46,1,29,2.17391304347826,63.0434782608696,47.8260869565217,52.1739130434783
"569","90","5",0,0,3,0,2,26,2,0,0,3,25,2,1,1,0,0,35,33,68,0,51,0,75,48.5294117647059,51.4705882352941
"570","90","6",10,5,14,0,14,18,0,0,5,9,18,0,0,0,0,0,63,33,96,10,36,10.4166666666667,37.5,34.375,65.625
"571","91","1",8,8,9,6,10,23,7,14,8,7,24,15,5,16,14,4,86,95,181,12,47,6.62983425414365,25.9668508287293,52.4861878453039,47.5138121546961
"572","91","2",28,11,14,4,17,29,6,2,11,7,32,4,1,8,2,1,112,68,180,29,61,16.1111111111111,33.8888888888889,37.7777777777778,62.2222222222222
"573","91","3",5,5,7,5,5,31,15,6,5,7,29,15,7,14,6,2,80,87,167,7,60,4.19161676646707,35.9281437125749,52.0958083832335,47.9041916167665
"574","91","4",11,5,7,6,7,24,8,5,5,8,24,8,6,7,5,6,74,71,145,17,48,11.7241379310345,33.1034482758621,48.9655172413793,51.0344827586207
"575","91","5",5,5,5,9,6,14,11,6,5,10,14,8,9,8,6,6,63,67,130,11,28,8.46153846153846,21.5384615384615,51.5384615384615,48.4615384615385
"576","91","6",9,8,14,6,11,15,12,2,7,12,12,8,8,5,2,3,78,59,137,12,27,8.75912408759124,19.7080291970803,43.0656934306569,56.9343065693431
"577","92","1",6,6,10,8,11,25,13,11,6,12,26,16,7,18,11,15,91,113,204,21,51,10.2941176470588,25,55.3921568627451,44.6078431372549
"578","92","2",4,5,7,10,13,16,8,14,5,11,22,12,3,19,14,35,78,123,201,39,38,19.4029850746269,18.9054726368159,61.1940298507463,38.8059701492537
"579","92","3",0,1,8,5,8,19,9,8,1,13,18,12,6,11,8,7,60,77,137,7,37,5.10948905109489,27.007299270073,56.2043795620438,43.7956204379562
"580","92","4",1,3,6,1,6,14,1,2,3,4,15,2,1,2,2,2,36,32,68,3,29,4.41176470588235,42.6470588235294,47.0588235294118,52.9411764705882
"581","92","5",1,2,2,0,1,11,2,2,2,0,10,4,1,3,3,9,22,34,56,10,21,17.8571428571429,37.5,60.7142857142857,39.2857142857143
"582","92","6",0,0,2,3,2,7,3,8,0,5,7,8,3,8,8,13,26,54,80,13,14,16.25,17.5,67.5,32.5
"583","93","1",20,12,11,11,14,7,5,8,12,10,10,2,9,5,8,4,90,61,151,24,17,15.8940397350993,11.2582781456954,40.3973509933775,59.6026490066225
"584","93","2",4,6,5,8,5,8,8,7,6,7,8,7,7,7,7,6,52,57,109,10,16,9.1743119266055,14.6788990825688,52.2935779816514,47.7064220183486
"585","93","3",8,14,11,9,8,6,9,5,13,6,3,5,11,2,5,7,71,54,125,15,9,12,7.2,43.2,56.8
"586","93","4",6,5,8,6,8,12,7,7,5,10,12,8,7,8,7,10,61,68,129,16,24,12.4031007751938,18.6046511627907,52.7131782945736,47.2868217054264
"587","93","5",25,9,11,1,7,6,6,4,9,2,3,9,4,6,4,1,71,39,110,26,9,23.6363636363636,8.18181818181818,35.4545454545455,64.5454545454545
"588","93","6",30,10,9,2,8,7,3,1,10,1,6,2,3,1,1,0,72,25,97,30,13,30.9278350515464,13.4020618556701,25.7731958762887,74.2268041237113
"589","94","1",4,2,10,3,10,25,10,2,2,12,25,9,3,9,2,3,68,66,134,7,50,5.22388059701493,37.3134328358209,49.2537313432836,50.7462686567164
"590","94","2",0,0,3,2,3,22,5,2,0,5,23,5,2,5,2,2,39,45,84,2,45,2.38095238095238,53.5714285714286,53.5714285714286,46.4285714285714
"591","94","3",0,1,1,0,1,32,2,0,1,0,33,2,0,2,0,0,39,39,78,0,65,0,83.3333333333333,50,50
"592","94","4",1,1,1,1,2,17,1,0,1,1,19,0,0,1,0,0,26,23,49,1,36,2.04081632653061,73.469387755102,46.9387755102041,53.0612244897959
"593","94","5",0,0,0,0,0,5,0,0,0,0,6,0,0,0,0,0,7,7,14,0,11,0,78.5714285714286,50,50
"594","94","6",0,0,0,1,1,4,0,0,0,1,5,0,0,0,0,0,7,8,15,0,9,0,60,53.3333333333333,46.6666666666667
"595","95","1",46,17,9,16,12,8,15,10,18,8,11,8,14,11,10,9,136,89,225,55,19,24.4444444444444,8.44444444444444,39.5555555555556,60.4444444444444
"596","95","2",15,17,21,13,18,14,15,7,17,17,11,8,17,5,7,10,122,93,215,25,25,11.6279069767442,11.6279069767442,43.2558139534884,56.7441860465116
"597","95","3",24,17,20,12,23,8,10,6,18,15,10,4,10,6,6,1,123,70,193,25,18,12.9533678756477,9.32642487046632,36.2694300518135,63.7305699481865
"598","95","4",36,14,20,4,20,12,6,2,14,10,11,4,4,4,2,0,115,51,166,36,23,21.6867469879518,13.855421686747,30.7228915662651,69.2771084337349
"599","95","5",43,18,14,12,12,16,11,6,18,8,13,5,14,2,6,7,133,75,208,50,29,24.0384615384615,13.9423076923077,36.0576923076923,63.9423076923077
"600","95","6",11,13,16,14,19,13,11,11,13,17,16,8,11,11,10,6,108,95,203,17,29,8.3743842364532,14.2857142857143,46.7980295566502,53.2019704433498
"601","96","1",6,5,10,3,11,23,3,5,5,9,24,5,3,5,5,4,68,61,129,10,47,7.75193798449612,36.4341085271318,47.2868217054264,52.7131782945736
"602","96","2",3,2,7,3,9,17,3,2,2,8,18,2,2,3,2,1,48,39,87,4,35,4.59770114942529,40.2298850574713,44.8275862068966,55.1724137931034
"603","96","3",7,5,5,3,2,18,6,2,4,3,16,5,5,3,2,1,50,40,90,8,34,8.88888888888889,37.7777777777778,44.4444444444444,55.5555555555556
"604","96","4",0,4,6,2,6,10,0,5,4,4,10,3,2,3,5,16,35,48,83,16,20,19.2771084337349,24.0963855421687,57.8313253012048,42.1686746987952
"605","96","5",0,1,1,1,1,9,2,4,1,1,9,5,1,5,4,8,20,36,56,8,18,14.2857142857143,32.1428571428571,64.2857142857143,35.7142857142857
"606","96","6",0,2,3,3,1,4,6,4,2,4,2,7,4,5,3,3,23,33,56,3,6,5.35714285714286,10.7142857142857,58.9285714285714,41.0714285714286
"607","97","1",9,5,13,4,13,18,8,6,5,12,17,10,4,9,5,5,76,70,146,14,35,9.58904109589041,23.972602739726,47.9452054794521,52.0547945205479
"608","97","2",2,2,8,7,7,18,6,7,3,13,17,6,8,5,7,8,60,67,127,10,35,7.8740157480315,27.5590551181102,52.755905511811,47.244094488189
"609","97","3",2,1,5,2,4,27,6,2,1,6,27,6,3,5,2,0,51,51,102,2,54,1.96078431372549,52.9411764705882,50,50
"610","97","4",0,0,2,3,3,15,6,0,0,5,16,3,2,4,0,0,30,32,62,0,31,0,50,51.6129032258064,48.3870967741936
"611","97","5",0,1,2,1,2,39,4,4,1,1,40,7,0,8,4,3,55,65,120,3,79,2.5,65.8333333333333,54.1666666666667,45.8333333333333
"612","97","6",0,0,3,1,4,37,5,2,0,4,38,6,0,7,2,1,53,60,113,1,75,0.884955752212389,66.3716814159292,53.0973451327434,46.9026548672566
"613","98","1",3,8,12,12,17,33,13,10,8,16,38,11,7,15,10,5,109,112,221,8,71,3.61990950226244,32.1266968325792,50.6787330316742,49.3212669683258
"614","98","2",6,4,8,11,12,29,16,23,3,15,33,28,6,33,23,43,110,186,296,49,62,16.5540540540541,20.9459459459459,62.8378378378378,37.1621621621622
"615","98","3",2,4,7,7,5,21,10,13,4,10,19,17,9,15,14,24,70,114,184,26,40,14.1304347826087,21.7391304347826,61.9565217391304,38.0434782608696
"616","98","4",0,0,3,5,1,23,10,23,0,7,21,28,6,26,22,65,65,178,243,65,44,26.7489711934156,18.1069958847737,73.2510288065844,26.7489711934156
"617","98","5",1,8,9,7,11,8,7,9,8,8,10,10,5,12,9,21,61,85,146,22,18,15.0684931506849,12.3287671232877,58.2191780821918,41.7808219178082
"618","98","6",0,1,2,5,3,30,6,13,1,6,31,14,4,16,13,15,61,102,163,15,61,9.20245398773006,37.4233128834356,62.5766871165644,37.4233128834356
"619","99","1",8,12,12,6,12,15,7,5,12,6,16,5,6,6,5,0,79,57,136,8,31,5.88235294117647,22.7941176470588,41.9117647058824,58.0882352941176
"620","99","2",1,1,13,1,11,20,3,2,1,13,18,4,3,2,2,0,54,44,98,1,38,1.02040816326531,38.7755102040816,44.8979591836735,55.1020408163265
"621","99","3",1,1,6,1,6,25,5,1,1,6,25,5,1,5,1,0,47,46,93,1,50,1.0752688172043,53.7634408602151,49.4623655913978,50.5376344086022
"622","99","4",0,0,1,0,0,19,4,7,0,1,19,11,1,10,7,2,33,52,85,2,38,2.35294117647059,44.7058823529412,61.1764705882353,38.8235294117647
"623","99","5",1,2,2,5,3,14,4,9,2,6,15,8,5,8,9,9,42,63,105,10,29,9.52380952380952,27.6190476190476,60,40
"624","99","6",13,6,7,5,6,9,8,6,7,6,7,9,7,7,6,7,63,56,119,20,16,16.8067226890756,13.4453781512605,47.0588235294118,52.9411764705882
