"","fish_id","bin","LLLL","LLLR","LLRL","LLRR","LRLL","LRLR","LRRL","LRRR","RLLL","RLLR","RLRL","RLRR","RRLL","RRLR","RRRL","RRRR","L","R","total_turns","reps","alts","rel_reps","rel_alts","rel_R","rel_L"
"1","1","1",16,8,8,7,9,3,6,2,8,7,5,1,6,3,2,2,61,35,96,18,8,18.75,8.33333333333333,36.4583333333333,63.5416666666667
"2","1","2",18,9,6,4,6,3,5,0,8,1,3,1,3,2,0,0,52,20,72,18,6,25,8.33333333333333,27.7777777777778,72.2222222222222
"3","1","3",19,8,10,2,11,3,0,1,7,4,4,0,0,1,1,2,55,21,76,21,7,27.6315789473684,9.21052631578947,27.6315789473684,72.3684210526316
"4","1","4",28,3,3,0,3,2,0,0,3,0,2,0,0,0,0,0,41,6,47,28,4,59.5744680851064,8.51063829787234,12.7659574468085,87.2340425531915
"5","1","5",36,5,6,1,5,2,2,0,6,2,1,1,3,0,1,0,60,14,74,36,3,48.6486486486486,4.05405405405405,18.9189189189189,81.0810810810811
"6","1","6",11,2,3,0,3,0,0,0,2,1,0,0,0,0,0,0,21,4,25,11,0,44,0,16,84
"7","10","1",8,6,4,6,5,3,5,9,6,4,4,8,5,10,9,8,47,56,103,16,7,15.5339805825243,6.79611650485437,54.3689320388349,45.6310679611651
"8","10","2",3,6,5,6,6,17,8,2,5,5,18,4,5,5,2,1,55,46,101,4,35,3.96039603960396,34.6534653465347,45.5445544554455,54.4554455445545
"9","10","3",3,3,4,5,4,9,5,6,3,6,9,6,5,6,6,7,40,50,90,10,18,11.1111111111111,20,55.5555555555556,44.4444444444444
"10","10","4",2,1,4,2,4,45,5,1,2,5,45,4,3,3,1,1,67,64,131,3,90,2.29007633587786,68.7022900763359,48.8549618320611,51.1450381679389
"11","10","5",6,5,5,0,4,7,3,2,6,0,5,5,2,3,2,1,35,24,59,7,12,11.864406779661,20.3389830508475,40.6779661016949,59.3220338983051
"12","10","6",0,3,5,1,5,4,2,3,3,2,4,4,0,5,3,3,24,26,50,3,8,6,16,52,48
"13","100","1",6,3,4,4,3,3,1,6,3,5,2,3,6,2,7,27,32,56,88,33,5,37.5,5.68181818181818,63.6363636363636,36.3636363636364
"14","100","2",6,4,7,0,7,8,0,1,3,3,8,1,0,1,1,3,35,21,56,9,16,16.0714285714286,28.5714285714286,37.5,62.5
"15","100","3",2,5,5,3,6,2,3,4,5,4,3,4,3,4,4,0,32,28,60,2,5,3.33333333333333,8.33333333333333,46.6666666666667,53.3333333333333
"16","100","4",2,6,7,3,6,6,5,2,6,4,5,5,4,3,2,3,38,34,72,5,11,6.94444444444444,15.2777777777778,47.2222222222222,52.7777777777778
"17","100","5",0,0,1,0,1,11,2,0,0,1,11,2,0,2,0,0,16,18,34,0,22,0,64.7058823529412,52.9411764705882,47.0588235294118
"18","100","6",0,0,1,1,2,11,2,0,0,2,12,1,0,2,0,0,19,18,37,0,23,0,62.1621621621622,48.6486486486486,51.3513513513514
"19","101","1",15,9,14,2,10,10,3,4,9,7,6,5,7,1,5,8,69,49,118,23,16,19.4915254237288,13.5593220338983,41.5254237288136,58.4745762711864
"20","101","2",1,2,5,3,4,10,3,5,2,6,9,5,4,5,5,3,34,41,75,4,19,5.33333333333333,25.3333333333333,54.6666666666667,45.3333333333333
"21","101","3",4,4,3,3,2,15,6,1,4,2,15,4,4,4,2,1,40,37,77,5,30,6.49350649350649,38.961038961039,48.0519480519481,51.9480519480519
"22","101","4",2,2,6,1,6,16,3,0,2,5,16,2,1,2,0,0,37,30,67,2,32,2.98507462686567,47.7611940298507,44.7761194029851,55.2238805970149
"23","101","5",2,2,7,1,6,6,3,3,2,6,4,5,2,3,2,1,30,28,58,3,10,5.17241379310345,17.2413793103448,48.2758620689655,51.7241379310345
"24","101","6",1,1,2,1,1,6,1,1,1,2,5,1,2,1,2,2,15,18,33,3,11,9.09090909090909,33.3333333333333,54.5454545454545,45.4545454545455
"25","102","1",2,4,7,9,6,5,10,9,4,12,4,10,10,9,9,8,54,67,121,10,9,8.26446280991735,7.43801652892562,55.3719008264463,44.6280991735537
"26","102","2",3,5,4,5,6,9,4,10,6,4,11,9,4,11,11,16,49,72,121,19,20,15.702479338843,16.5289256198347,59.504132231405,40.495867768595
"27","102","3",0,3,9,4,5,15,12,7,3,10,11,14,8,10,7,5,56,70,126,5,26,3.96825396825397,20.6349206349206,55.5555555555556,44.4444444444444
"28","102","4",1,1,2,6,2,9,7,8,1,8,9,9,6,9,8,9,38,60,98,10,18,10.2040816326531,18.3673469387755,61.2244897959184,38.7755102040816
"29","102","5",0,0,2,7,3,5,3,12,0,9,6,7,6,9,12,17,33,68,101,17,11,16.8316831683168,10.8910891089109,67.3267326732673,32.6732673267327
"30","102","6",1,7,5,8,7,13,6,12,7,6,15,10,6,11,11,24,59,93,152,25,28,16.4473684210526,18.4210526315789,61.1842105263158,38.8157894736842
"31","103","1",7,9,9,5,9,12,4,5,9,5,11,4,5,3,4,1,60,45,105,8,23,7.61904761904762,21.9047619047619,42.8571428571429,57.1428571428571
"32","103","2",2,3,2,2,1,11,7,3,3,2,10,7,4,6,3,0,33,36,69,2,21,2.89855072463768,30.4347826086957,52.1739130434783,47.8260869565217
"33","103","3",6,4,7,1,6,5,4,4,4,4,4,8,2,6,4,3,38,37,75,9,9,12,12,49.3333333333333,50.6666666666667
"34","103","4",0,0,1,1,0,9,3,8,0,2,9,9,2,9,8,6,24,46,70,6,18,8.57142857142857,25.7142857142857,65.7142857142857,34.2857142857143
"35","103","5",0,0,1,0,1,18,2,0,0,1,19,2,0,2,0,0,24,25,49,0,37,0,75.5102040816327,51.0204081632653,48.9795918367347
"36","103","6",0,1,2,1,2,2,1,2,1,2,2,2,1,2,2,2,12,16,28,2,4,7.14285714285714,14.2857142857143,57.1428571428571,42.8571428571429
"37","104","1",8,12,15,7,14,6,9,4,13,10,5,5,9,4,4,0,78,50,128,8,11,6.25,8.59375,39.0625,60.9375
"38","104","2",6,8,9,3,8,10,4,6,8,4,9,7,4,6,6,4,57,48,105,10,19,9.52380952380952,18.0952380952381,45.7142857142857,54.2857142857143
"39","104","3",13,6,8,5,9,7,4,1,6,7,7,1,4,1,1,0,54,29,83,13,14,15.6626506024096,16.8674698795181,34.9397590361446,65.0602409638554
"40","104","4",103,6,5,3,7,3,2,1,7,2,4,0,2,1,1,0,133,17,150,103,7,68.6666666666667,4.66666666666667,11.3333333333333,88.6666666666667
"41","104","5",75,9,10,0,10,0,0,0,9,1,0,0,0,0,0,0,107,10,117,75,0,64.1025641025641,0,8.54700854700855,91.4529914529915
"42","104","6",147,2,3,0,3,1,0,0,3,0,1,0,0,0,0,0,159,4,163,147,2,90.1840490797546,1.22699386503067,2.45398773006135,97.5460122699387
"43","105","1",11,7,6,4,4,7,5,3,7,4,5,4,6,2,3,4,49,36,85,15,12,17.6470588235294,14.1176470588235,42.3529411764706,57.6470588235294
"44","105","2",3,4,10,2,10,11,2,3,5,8,10,3,3,2,3,1,48,35,83,4,21,4.81927710843374,25.3012048192771,42.1686746987952,57.8313253012048
"45","105","3",8,5,4,4,4,1,2,5,5,3,1,3,5,3,5,5,35,31,66,13,2,19.6969696969697,3.03030303030303,46.969696969697,53.030303030303
"46","105","4",14,4,4,1,4,3,3,1,4,2,3,3,2,3,2,0,36,20,56,14,6,25,10.7142857142857,35.7142857142857,64.2857142857143
"47","105","5",9,6,4,2,4,0,1,1,6,1,0,0,2,0,1,0,29,11,40,9,0,22.5,0,27.5,72.5
"48","105","6",15,4,2,1,1,1,1,1,3,0,0,1,2,0,1,0,28,8,36,15,1,41.6666666666667,2.77777777777778,22.2222222222222,77.7777777777778
"49","106","1",5,7,7,4,6,4,4,5,7,5,2,5,6,3,5,3,44,37,81,8,6,9.87654320987654,7.40740740740741,45.679012345679,54.320987654321
"50","106","2",3,4,3,5,3,13,6,5,4,4,13,7,5,7,5,9,43,56,99,12,26,12.1212121212121,26.2626262626263,56.5656565656566,43.4343434343434
"51","106","3",0,1,1,3,2,7,5,6,1,3,8,7,2,9,6,23,26,61,87,23,15,26.4367816091954,17.2413793103448,70.1149425287356,29.8850574712644
"52","106","4",3,2,1,2,0,7,1,5,2,1,6,5,3,4,6,14,22,43,65,17,13,26.1538461538462,20,66.1538461538462,33.8461538461538
"53","106","5",3,2,4,2,3,10,2,4,2,4,8,5,3,3,4,0,31,31,62,3,18,4.83870967741935,29.0322580645161,50,50
"54","106","6",1,3,5,3,2,8,6,5,3,5,4,9,6,5,5,1,34,40,74,2,12,2.7027027027027,16.2162162162162,54.0540540540541,45.9459459459459
"55","107","1",8,5,5,5,6,6,5,5,5,5,7,5,3,7,5,3,46,42,88,11,13,12.5,14.7727272727273,47.7272727272727,52.2727272727273
"56","107","2",0,4,5,2,3,10,4,4,4,3,8,6,4,4,4,6,33,41,74,6,18,8.10810810810811,24.3243243243243,55.4054054054054,44.5945945945946
"57","107","3",2,1,7,2,4,9,7,1,1,8,7,6,5,3,1,2,35,34,69,4,16,5.79710144927536,23.1884057971014,49.2753623188406,50.7246376811594
"58","107","4",6,5,3,5,4,10,6,3,5,3,12,4,4,5,3,1,44,38,82,7,22,8.53658536585366,26.8292682926829,46.3414634146341,53.6585365853659
"59","107","5",4,5,6,4,5,5,4,2,4,5,5,2,4,2,2,1,37,26,63,5,10,7.93650793650794,15.8730158730159,41.2698412698413,58.7301587301587
"60","107","6",2,2,4,0,2,8,2,1,2,2,5,3,2,1,1,1,22,19,41,3,13,7.31707317073171,31.7073170731707,46.3414634146341,53.6585365853659
"61","108","1",1,4,4,4,3,9,5,8,4,4,8,9,5,7,7,30,38,77,115,31,17,26.9565217391304,14.7826086956522,66.9565217391304,33.0434782608696
"62","108","2",0,2,1,6,2,7,4,10,1,5,8,8,4,9,9,26,32,73,105,26,15,24.7619047619048,14.2857142857143,69.5238095238095,30.4761904761905
"63","108","3",0,1,1,2,0,4,1,9,1,3,3,8,3,7,9,31,20,66,86,31,7,36.046511627907,8.13953488372093,76.7441860465116,23.2558139534884
"64","108","4",9,4,6,2,7,5,2,1,4,4,6,1,1,1,0,1,36,21,57,10,11,17.5438596491228,19.2982456140351,36.8421052631579,63.1578947368421
"65","108","5",3,4,5,1,4,6,3,1,4,3,5,3,3,1,1,1,29,22,51,4,11,7.84313725490196,21.5686274509804,43.1372549019608,56.8627450980392
"66","108","6",2,2,2,0,3,8,0,1,3,0,9,1,0,1,1,1,21,16,37,3,17,8.10810810810811,45.9459459459459,43.2432432432432,56.7567567567568
"67","109","1",3,7,7,4,7,11,3,5,7,4,11,4,4,4,5,1,50,40,90,4,22,4.44444444444444,24.4444444444444,44.4444444444444,55.5555555555556
"68","109","2",6,5,8,8,9,5,7,2,5,10,7,1,6,3,2,1,52,36,88,7,12,7.95454545454545,13.6363636363636,40.9090909090909,59.0909090909091
"69","109","3",0,1,2,4,6,1,4,1,1,5,5,2,0,5,1,3,20,24,44,3,6,6.81818181818182,13.6363636363636,54.5454545454545,45.4545454545455
"70","109","4",0,1,0,1,0,0,0,2,1,0,0,0,1,0,1,1,4,7,11,1,0,9.09090909090909,0,63.6363636363636,36.3636363636364
"71","109","5",0,0,0,0,0,2,0,1,0,0,2,1,0,1,1,1,5,7,12,1,4,8.33333333333333,33.3333333333333,58.3333333333333,41.6666666666667
"72","109","6",0,0,0,0,0,2,0,1,0,0,2,1,0,0,0,0,3,6,9,0,4,0,44.4444444444444,66.6666666666667,33.3333333333333
"73","11","1",4,4,4,6,5,4,6,7,4,6,6,6,5,8,7,16,42,59,101,20,10,19.8019801980198,9.9009900990099,58.4158415841584,41.5841584158416
"74","11","2",6,4,1,4,1,1,5,5,4,1,2,6,4,7,5,9,29,39,68,15,3,22.0588235294118,4.41176470588235,57.3529411764706,42.6470588235294
"75","11","3",10,4,4,3,5,8,4,1,4,3,8,2,2,3,1,0,40,25,65,10,16,15.3846153846154,24.6153846153846,38.4615384615385,61.5384615384615
"76","11","4",1,2,1,3,2,0,5,2,2,2,1,4,2,5,2,7,18,26,44,8,1,18.1818181818182,2.27272727272727,59.0909090909091,40.9090909090909
"77","11","5",0,2,1,4,1,1,4,4,2,2,1,4,3,4,4,8,18,30,48,8,2,16.6666666666667,4.16666666666667,62.5,37.5
"78","11","6",3,3,3,1,2,4,1,1,3,1,3,1,2,0,1,1,18,15,33,4,7,12.1212121212121,21.2121212121212,45.4545454545455,54.5454545454545
"79","12","1",0,4,3,4,2,12,9,3,4,2,12,8,4,8,3,0,39,42,81,0,24,0,29.6296296296296,51.8518518518519,48.1481481481481
"80","12","2",0,0,0,1,1,5,1,0,0,1,7,0,0,1,0,0,10,10,20,0,12,0,60,50,50
"81","12","3",1,1,3,0,1,4,1,0,1,2,2,1,1,0,0,0,12,9,21,1,6,4.76190476190476,28.5714285714286,42.8571428571429,57.1428571428571
"82","12","4",0,0,2,1,2,4,2,0,0,3,4,1,0,2,0,0,12,12,24,0,8,0,33.3333333333333,50,50
"83","12","5",0,0,1,0,0,3,1,0,0,1,1,1,1,0,0,0,6,6,12,0,4,0,33.3333333333333,50,50
"84","12","6",0,0,0,2,1,1,0,1,0,2,1,0,1,0,1,1,6,8,14,1,2,7.14285714285714,14.2857142857143,57.1428571428571,42.8571428571429
"85","13","1",2,2,5,2,4,6,7,5,2,5,5,9,4,8,5,14,35,53,88,16,11,18.1818181818182,12.5,60.2272727272727,39.7727272727273
"86","13","2",3,3,5,2,4,12,5,1,3,4,12,4,3,3,1,2,37,33,70,5,24,7.14285714285714,34.2857142857143,47.1428571428571,52.8571428571429
"87","13","3",0,5,5,5,5,3,8,4,5,5,3,7,5,7,4,3,36,41,77,3,6,3.8961038961039,7.79220779220779,53.2467532467532,46.7532467532468
"88","13","4",7,4,3,3,3,3,5,3,4,1,3,5,3,5,3,0,33,25,58,7,6,12.0689655172414,10.3448275862069,43.1034482758621,56.8965517241379
"89","13","5",9,4,5,5,5,3,3,4,4,5,3,2,4,2,3,2,38,28,66,11,6,16.6666666666667,9.09090909090909,42.4242424242424,57.5757575757576
"90","13","6",2,2,7,1,7,7,2,2,2,6,6,4,1,3,2,2,31,28,59,4,13,6.77966101694915,22.0338983050847,47.4576271186441,52.5423728813559
"91","14","1",4,4,5,6,8,12,4,4,4,7,15,3,3,5,4,5,48,48,96,9,27,9.375,28.125,50,50
"92","14","2",1,4,5,4,7,10,4,5,4,5,12,4,3,6,5,3,42,43,85,4,22,4.70588235294118,25.8823529411765,50.5882352941176,49.4117647058824
"93","14","3",9,5,4,5,7,6,3,3,6,4,8,1,3,3,3,2,45,30,75,11,14,14.6666666666667,18.6666666666667,40,60
"94","14","4",6,6,5,7,5,3,6,1,6,6,3,0,6,1,1,0,40,25,65,6,6,9.23076923076923,9.23076923076923,38.4615384615385,61.5384615384615
"95","14","5",21,4,4,3,5,2,3,1,5,3,2,1,3,1,1,0,46,16,62,21,4,33.8709677419355,6.45161290322581,25.8064516129032,74.1935483870968
"96","14","6",7,4,6,2,7,9,3,1,4,5,10,2,2,3,1,0,41,28,69,7,19,10.1449275362319,27.536231884058,40.5797101449275,59.4202898550725
"97","17","1",0,2,7,5,6,8,5,3,2,10,8,3,6,2,3,2,38,37,75,2,16,2.66666666666667,21.3333333333333,49.3333333333333,50.6666666666667
"98","17","2",0,2,5,0,4,8,3,0,2,3,7,3,2,1,0,0,24,19,43,0,15,0,34.8837209302326,44.1860465116279,55.8139534883721
"99","17","3",9,5,4,5,5,10,6,2,5,4,10,3,4,4,2,0,47,34,81,9,20,11.1111111111111,24.6913580246914,41.9753086419753,58.0246913580247
"100","17","4",15,5,8,1,6,28,5,0,5,4,25,4,3,2,0,0,69,45,114,15,53,13.1578947368421,46.4912280701754,39.4736842105263,60.5263157894737
"101","17","5",7,6,7,0,5,45,3,0,6,2,42,3,3,0,0,0,75,57,132,7,87,5.3030303030303,65.9090909090909,43.1818181818182,56.8181818181818
"102","17","6",2,2,3,0,2,56,1,0,2,1,55,1,1,0,0,0,68,61,129,2,111,1.55038759689922,86.046511627907,47.2868217054264,52.7131782945736
"103","18","1",3,6,8,4,6,11,4,4,6,6,9,4,6,2,3,1,46,40,86,4,20,4.65116279069767,23.2558139534884,46.5116279069767,53.4883720930233
"104","18","2",10,8,11,5,6,14,7,4,8,7,9,6,9,2,4,4,66,51,117,14,23,11.965811965812,19.6581196581197,43.5897435897436,56.4102564102564
"105","18","3",13,12,10,3,9,7,1,4,11,2,6,2,4,1,4,2,61,33,94,15,13,15.9574468085106,13.8297872340426,35.1063829787234,64.8936170212766
"106","18","4",6,6,7,3,8,1,5,0,6,4,2,2,2,3,0,0,38,20,58,6,3,10.3448275862069,5.17241379310345,34.4827586206897,65.5172413793103
"107","18","5",25,4,4,1,5,0,1,0,4,1,1,0,1,1,1,1,42,11,53,26,1,49.0566037735849,1.88679245283019,20.7547169811321,79.2452830188679
"108","18","6",43,3,2,1,2,0,1,0,3,0,0,0,1,0,0,0,55,4,59,43,0,72.8813559322034,0,6.77966101694915,93.2203389830509
"109","19","1",7,8,11,4,12,20,3,3,8,7,21,3,3,4,4,4,69,56,125,11,41,8.8,32.8,44.8,55.2
"110","19","2",1,2,9,0,9,28,1,0,2,7,29,1,0,1,0,0,52,41,93,1,57,1.0752688172043,61.2903225806452,44.0860215053763,55.9139784946237
"111","19","3",7,3,7,3,8,14,5,1,4,7,14,3,3,3,1,1,51,36,87,8,28,9.19540229885057,32.183908045977,41.3793103448276,58.6206896551724
"112","19","4",2,2,2,2,1,3,3,3,3,1,2,4,3,3,3,2,21,21,42,4,5,9.52380952380952,11.9047619047619,50,50
"113","19","5",0,0,2,2,2,2,3,3,0,4,1,4,2,4,3,4,15,24,39,4,3,10.2564102564103,7.69230769230769,61.5384615384615,38.4615384615385
"114","19","6",1,1,1,2,2,6,3,2,1,3,6,3,2,3,2,7,20,28,48,8,12,16.6666666666667,25,58.3333333333333,41.6666666666667
"115","2","1",1,3,4,6,6,13,5,11,3,7,15,9,4,11,10,18,49,80,129,19,28,14.7286821705426,21.7054263565891,62.015503875969,37.984496124031
"116","2","2",3,9,10,8,9,6,12,7,9,9,5,11,9,10,7,5,65,67,132,8,11,6.06060606060606,8.33333333333333,50.7575757575758,49.2424242424242
"117","2","3",3,4,4,5,6,8,4,5,4,5,9,5,3,6,5,5,40,44,84,8,17,9.52380952380952,20.2380952380952,52.3809523809524,47.6190476190476
"118","2","4",1,2,4,2,2,6,3,5,2,3,5,6,3,5,5,4,27,34,61,5,11,8.19672131147541,18.0327868852459,55.7377049180328,44.2622950819672
"119","2","5",2,6,4,4,5,5,3,3,6,2,6,2,2,3,2,2,32,28,60,4,11,6.66666666666667,18.3333333333333,46.6666666666667,53.3333333333333
"120","2","6",1,4,4,4,5,5,4,2,4,4,6,3,3,3,2,2,30,29,59,3,11,5.08474576271186,18.6440677966102,49.1525423728814,50.8474576271186
"121","20","1",11,7,9,5,10,13,5,4,7,7,13,4,5,4,4,4,66,49,115,15,26,13.0434782608696,22.6086956521739,42.6086956521739,57.3913043478261
"122","20","2",0,1,1,0,0,64,5,0,1,0,64,5,1,4,0,0,73,76,149,0,128,0,85.9060402684564,51.006711409396,48.993288590604
"123","20","3",6,6,8,6,6,35,8,6,7,8,33,7,9,5,6,3,84,78,162,9,68,5.55555555555556,41.9753086419753,48.1481481481481,51.8518518518519
"124","20","4",6,7,10,3,6,37,4,5,7,6,33,6,7,3,5,2,79,71,150,8,70,5.33333333333333,46.6666666666667,47.3333333333333,52.6666666666667
"125","20","5",0,0,8,3,3,40,9,2,0,11,35,8,8,3,2,4,67,72,139,4,75,2.87769784172662,53.9568345323741,51.7985611510791,48.2014388489209
"126","20","6",0,0,3,2,2,62,5,2,0,6,61,5,4,3,2,0,78,82,160,0,123,0,76.875,51.25,48.75
"127","21","1",3,8,8,6,7,9,6,7,8,5,8,7,7,6,7,9,56,58,114,12,17,10.5263157894737,14.9122807017544,50.8771929824561,49.1228070175439
"128","21","2",16,9,7,5,7,4,4,4,9,3,4,3,5,3,4,2,58,34,92,18,8,19.5652173913043,8.69565217391304,36.9565217391304,63.0434782608696
"129","21","3",4,5,8,2,6,9,4,3,5,5,7,6,4,3,3,2,42,37,79,6,16,7.59493670886076,20.253164556962,46.8354430379747,53.1645569620253
"130","21","4",11,5,4,3,6,7,1,2,5,2,9,0,1,2,2,0,41,22,63,11,16,17.4603174603175,25.3968253968254,34.9206349206349,65.0793650793651
"131","21","5",2,5,4,5,5,7,7,1,5,4,8,3,4,4,1,3,38,33,71,5,15,7.04225352112676,21.1267605633803,46.4788732394366,53.5211267605634
"132","21","6",7,3,3,0,0,16,2,0,3,0,14,2,2,0,0,0,33,22,55,7,30,12.7272727272727,54.5454545454545,40,60
"133","22","1",20,8,7,6,9,16,7,2,8,5,18,3,3,6,2,2,76,49,125,22,34,17.6,27.2,39.2,60.8
"134","22","2",2,3,5,4,6,16,7,3,3,6,17,6,3,7,3,1,48,47,95,3,33,3.15789473684211,34.7368421052632,49.4736842105263,50.5263157894737
"135","22","3",6,4,3,4,4,13,2,10,4,3,15,8,3,9,10,15,48,68,116,21,28,18.1034482758621,24.1379310344828,58.6206896551724,41.3793103448276
"136","22","4",4,3,2,2,2,4,4,6,3,2,4,8,2,8,6,12,29,46,75,16,8,21.3333333333333,10.6666666666667,61.3333333333333,38.6666666666667
"137","22","5",3,3,1,7,4,4,5,5,2,5,7,3,3,6,5,4,33,37,70,7,11,10,15.7142857142857,52.8571428571429,47.1428571428571
"138","22","6",0,2,4,3,4,9,7,3,2,5,9,7,3,7,3,1,33,39,72,1,18,1.38888888888889,25,54.1666666666667,45.8333333333333
"139","23","1",8,6,10,5,10,9,4,6,6,8,10,5,4,6,6,7,60,53,113,15,19,13.2743362831858,16.8141592920354,46.9026548672566,53.0973451327434
"140","23","2",1,4,9,2,10,12,4,2,4,8,13,4,1,5,2,0,46,38,84,1,25,1.19047619047619,29.7619047619048,45.2380952380952,54.7619047619048
"141","23","3",5,3,4,2,4,21,3,0,3,3,20,1,2,1,0,0,43,32,75,5,41,6.66666666666667,54.6666666666667,42.6666666666667,57.3333333333333
"142","23","4",1,0,2,1,3,9,1,0,1,3,10,0,1,0,0,0,20,15,35,1,19,2.85714285714286,54.2857142857143,42.8571428571429,57.1428571428571
"143","23","5",1,2,4,1,4,9,5,0,2,3,9,4,2,3,0,0,28,24,52,1,18,1.92307692307692,34.6153846153846,46.1538461538462,53.8461538461538
"144","23","6",1,1,3,0,3,9,0,0,1,3,9,0,0,0,0,0,19,14,33,1,18,3.03030303030303,54.5454545454545,42.4242424242424,57.5757575757576
"145","24","1",10,6,6,8,8,16,11,7,6,8,18,10,6,11,6,5,72,73,145,15,34,10.3448275862069,23.448275862069,50.3448275862069,49.6551724137931
"146","24","2",10,9,12,9,11,12,11,5,9,12,10,7,11,5,5,3,81,63,144,13,22,9.02777777777778,15.2777777777778,43.75,56.25
"147","24","3",0,2,7,1,4,15,5,2,2,7,11,6,5,2,2,2,38,38,76,2,26,2.63157894736842,34.2105263157895,50,50
"148","24","4",2,1,2,0,1,6,1,1,2,1,4,2,2,0,1,0,17,12,29,2,10,6.89655172413793,34.4827586206897,41.3793103448276,58.6206896551724
"149","24","5",1,1,1,0,0,1,0,1,0,0,0,1,0,1,1,1,6,6,12,2,1,16.6666666666667,8.33333333333333,50,50
"150","24","6",0,0,1,0,1,2,1,0,0,1,1,1,1,0,0,0,7,5,12,0,3,0,25,41.6666666666667,58.3333333333333
"151","27","1",0,2,1,3,1,5,7,2,2,2,6,6,3,6,2,1,23,29,52,1,11,1.92307692307692,21.1538461538462,55.7692307692308,44.2307692307692
"152","27","2",0,2,2,4,4,6,3,5,2,4,7,5,2,6,5,5,27,38,65,5,13,7.69230769230769,20,58.4615384615385,41.5384615384615
"153","27","3",4,1,2,1,1,2,0,6,1,2,1,5,2,4,5,7,17,30,47,11,3,23.4042553191489,6.38297872340426,63.8297872340426,36.1702127659574
"154","27","4",0,1,2,2,1,2,2,3,0,3,1,3,2,2,2,1,13,17,30,1,3,3.33333333333333,10,56.6666666666667,43.3333333333333
"155","27","5",0,1,0,1,0,0,2,1,1,0,0,2,1,2,1,0,7,8,15,0,0,0,0,53.3333333333333,46.6666666666667
"156","27","6",11,2,1,3,2,0,1,2,2,2,1,0,2,1,2,4,23,16,39,15,1,38.4615384615385,2.56410256410256,41.025641025641,58.974358974359
"157","28","1",11,7,4,5,4,3,3,4,7,2,3,2,4,2,4,1,42,27,69,12,6,17.3913043478261,8.69565217391304,39.1304347826087,60.8695652173913
"158","28","2",2,3,2,6,5,0,4,5,3,6,3,3,4,5,5,6,29,36,65,8,3,12.3076923076923,4.61538461538461,55.3846153846154,44.6153846153846
"159","28","3",1,1,6,2,6,7,2,3,1,7,7,2,2,2,3,0,29,26,55,1,14,1.81818181818182,25.4545454545455,47.2727272727273,52.7272727272727
"160","28","4",3,2,3,3,3,1,4,2,2,4,1,3,3,3,2,0,23,19,42,3,2,7.14285714285714,4.76190476190476,45.2380952380952,54.7619047619048
"161","28","5",2,2,2,3,2,1,1,3,2,2,1,1,2,2,3,4,17,19,36,6,2,16.6666666666667,5.55555555555556,52.7777777777778,47.2222222222222
"162","28","6",1,1,0,3,0,0,1,2,1,2,1,0,2,1,2,11,10,21,31,12,1,38.7096774193548,3.2258064516129,67.741935483871,32.258064516129
"163","3","1",4,5,4,6,6,10,3,6,5,5,13,3,4,5,6,5,46,47,93,9,23,9.67741935483871,24.7311827956989,50.5376344086022,49.4623655913978
"164","3","2",1,1,4,2,3,6,6,2,2,5,5,6,4,4,2,0,28,28,56,1,11,1.78571428571429,19.6428571428571,50,50
"165","3","3",2,2,2,2,3,3,2,3,3,2,3,3,2,3,3,4,22,23,45,6,6,13.3333333333333,13.3333333333333,51.1111111111111,48.8888888888889
"166","3","4",2,1,2,0,2,7,1,1,2,1,7,2,0,2,1,1,19,16,35,3,14,8.57142857142857,40,45.7142857142857,54.2857142857143
"167","3","5",7,1,2,1,3,3,0,3,1,2,4,2,0,3,3,4,20,22,42,11,7,26.1904761904762,16.6666666666667,52.3809523809524,47.6190476190476
"168","3","6",0,2,2,0,1,20,1,1,2,1,19,2,2,1,2,1,29,31,60,1,39,1.66666666666667,65,51.6666666666667,48.3333333333333
"169","31","1",2,6,9,4,6,10,7,5,5,7,8,8,6,6,5,3,51,49,100,5,18,5,18,49,51
"170","31","2",1,3,4,4,3,11,3,4,3,5,11,3,5,2,4,1,35,35,70,2,22,2.85714285714286,31.4285714285714,50,50
"171","31","3",7,3,2,4,2,3,7,2,3,3,3,5,3,5,1,2,30,28,58,9,6,15.5172413793103,10.3448275862069,48.2758620689655,51.7241379310345
"172","31","4",4,7,6,3,3,5,4,1,6,2,2,2,5,0,1,2,34,22,56,6,7,10.7142857142857,12.5,39.2857142857143,60.7142857142857
"173","31","5",4,3,1,3,4,3,3,4,3,1,6,3,0,7,4,4,26,30,56,8,9,14.2857142857143,16.0714285714286,53.5714285714286,46.4285714285714
"174","31","6",11,5,2,2,4,1,1,2,5,0,3,1,1,3,3,2,30,19,49,13,4,26.530612244898,8.16326530612245,38.7755102040816,61.2244897959184
"175","32","1",4,4,4,5,3,3,5,2,3,5,2,2,5,1,2,0,31,22,53,4,5,7.54716981132075,9.43396226415094,41.5094339622642,58.4905660377358
"176","32","2",5,5,7,3,6,6,4,5,5,5,5,6,4,5,4,2,41,39,80,7,11,8.75,13.75,48.75,51.25
"177","32","3",3,5,10,2,9,7,2,2,4,7,7,2,2,2,2,1,42,28,70,4,14,5.71428571428571,20,40,60
"178","32","4",15,7,7,0,6,15,0,0,6,0,15,0,0,0,0,0,52,22,74,15,30,20.2702702702703,40.5405405405405,29.7297297297297,70.2702702702703
"179","32","5",1,2,5,4,2,23,10,3,2,7,20,9,7,5,2,3,50,58,108,4,43,3.7037037037037,39.8148148148148,53.7037037037037,46.2962962962963
"180","32","6",10,7,10,5,9,9,8,0,7,8,8,3,6,2,0,0,60,35,95,10,17,10.5263157894737,17.8947368421053,36.8421052631579,63.1578947368421
"181","33","1",12,4,2,5,4,3,5,3,4,3,4,3,4,4,3,2,40,28,68,14,7,20.5882352941176,10.2941176470588,41.1764705882353,58.8235294117647
"182","33","2",4,3,2,3,0,6,4,3,3,2,3,5,5,2,3,2,26,27,53,6,9,11.3207547169811,16.9811320754717,50.9433962264151,49.0566037735849
"183","33","3",5,2,2,2,4,3,2,2,3,1,5,2,0,4,2,2,25,19,44,7,8,15.9090909090909,18.1818181818182,43.1818181818182,56.8181818181818
"184","33","4",20,4,4,1,6,0,1,0,5,1,1,0,0,1,0,0,39,8,47,20,1,42.5531914893617,2.12765957446809,17.0212765957447,82.9787234042553
"185","33","5",9,3,1,2,1,1,2,1,3,0,1,2,2,2,1,0,21,13,34,9,2,26.4705882352941,5.88235294117647,38.2352941176471,61.7647058823529
"186","33","6",1,2,4,0,3,7,1,0,2,2,6,1,1,0,0,0,20,13,33,1,13,3.03030303030303,39.3939393939394,39.3939393939394,60.6060606060606
"187","34","1",4,4,4,2,4,1,2,1,4,1,1,1,2,1,1,2,24,14,38,6,2,15.7894736842105,5.26315789473684,36.8421052631579,63.1578947368421
"188","34","2",1,3,7,1,6,3,3,0,3,5,1,2,2,1,0,0,25,16,41,1,4,2.4390243902439,9.75609756097561,39.0243902439024,60.9756097560976
"189","34","3",1,1,2,0,1,10,1,0,1,1,8,1,1,0,0,0,17,14,31,1,18,3.2258064516129,58.0645161290323,45.1612903225806,54.8387096774194
"190","34","4",0,0,0,0,0,6,0,0,0,0,5,0,0,0,0,0,7,7,14,0,11,0,78.5714285714286,50,50
"191","34","5",0,0,0,0,0,0,0,0,0,0,0,0,0,0,0,0,0,0,0,0,0,NA,NA,NA,NA
"192","34","6",0,0,0,0,0,0,0,0,0,0,0,0,0,0,0,0,0,0,0,0,0,NA,NA,NA,NA
"193","37","1",4,4,4,2,5,11,4,0,4,3,12,1,2,2,0,0,36,25,61,4,23,6.55737704918033,37.7049180327869,40.9836065573771,59.0163934426229
"194","37","2",0,0,0,4,2,4,4,0,0,5,6,0,3,1,0,0,16,16,32,0,10,0,31.25,50,50
"195","37","3",0,0,0,0,0,3,1,0,0,0,3,1,0,1,0,0,6,6,12,0,6,0,50,50,50
"196","37","4",0,0,0,0,0,0,0,0,0,0,0,0,0,0,0,0,0,0,0,0,0,NA,NA,NA,NA
"197","37","5",0,0,1,0,0,1,0,0,0,1,0,0,0,0,0,0,3,3,6,0,1,0,16.6666666666667,50,50
"198","37","6",0,0,0,0,0,2,0,1,0,0,2,1,0,1,1,0,4,7,11,0,4,0,36.3636363636364,63.6363636363636,36.3636363636364
"199","38","1",1,4,4,5,4,5,4,6,4,5,5,5,4,5,6,3,34,39,73,4,10,5.47945205479452,13.6986301369863,53.4246575342466,46.5753424657534
"200","38","2",0,2,5,2,1,13,7,5,2,5,10,10,5,7,5,0,37,45,82,0,23,0,28.0487804878049,54.8780487804878,45.1219512195122
"201","38","3",0,2,4,1,3,6,1,2,3,3,5,2,2,1,2,3,22,21,43,3,11,6.97674418604651,25.5813953488372,48.8372093023256,51.1627906976744
"202","38","4",0,0,0,0,0,0,0,0,0,0,0,0,0,0,0,0,0,0,0,0,0,NA,NA,NA,NA
"203","38","5",0,2,2,1,2,9,2,0,2,1,10,1,1,2,0,0,20,18,38,0,19,0,50,47.3684210526316,52.6315789473684
"204","38","6",0,2,0,3,1,6,1,4,1,1,7,2,1,3,4,4,18,25,43,4,13,9.30232558139535,30.2325581395349,58.1395348837209,41.8604651162791
"205","4","1",2,1,1,4,1,3,10,5,1,4,3,11,3,12,5,9,28,50,78,11,6,14.1025641025641,7.69230769230769,64.1025641025641,35.8974358974359
"206","4","2",5,3,4,3,5,5,3,1,3,4,6,2,2,2,1,0,30,22,52,5,11,9.61538461538461,21.1538461538462,42.3076923076923,57.6923076923077
"207","4","3",0,2,1,1,2,0,3,1,2,0,1,3,0,4,1,0,11,13,24,0,1,0,4.16666666666667,54.1666666666667,45.8333333333333
"208","4","4",4,3,2,2,2,0,1,1,3,1,0,0,2,0,1,0,18,7,25,4,0,16,0,28,72
"209","4","5",5,1,1,0,0,2,1,0,0,0,1,1,0,0,0,0,11,4,15,5,3,33.3333333333333,20,26.6666666666667,73.3333333333333
"210","4","6",7,5,5,1,5,1,0,1,4,1,1,0,0,0,0,0,25,9,34,7,2,20.5882352941176,5.88235294117647,26.4705882352941,73.5294117647059
"211","41","1",29,10,8,4,8,6,5,1,10,2,6,2,4,2,1,0,71,30,101,29,12,28.7128712871287,11.8811881188119,29.7029702970297,70.2970297029703
"212","41","2",5,5,4,4,4,8,6,2,5,3,9,3,4,4,2,0,40,31,71,5,17,7.04225352112676,23.943661971831,43.6619718309859,56.3380281690141
"213","41","3",3,5,6,3,7,3,3,1,6,4,3,1,3,1,1,2,34,21,55,5,6,9.09090909090909,10.9090909090909,38.1818181818182,61.8181818181818
"214","41","4",0,0,2,3,2,0,3,0,1,5,0,0,3,0,0,0,13,9,22,0,0,0,0,40.9090909090909,59.0909090909091
"215","41","5",14,2,2,2,2,0,2,1,1,2,0,1,2,1,1,1,27,10,37,15,0,40.5405405405405,0,27.027027027027,72.972972972973
"216","41","6",7,2,2,1,2,3,1,0,3,1,3,0,1,0,0,0,21,8,29,7,6,24.1379310344828,20.6896551724138,27.5862068965517,72.4137931034483
"217","42","1",7,9,11,3,10,11,9,6,9,5,10,12,4,10,5,1,66,59,125,8,21,6.4,16.8,47.2,52.8
"218","42","2",6,5,7,7,7,8,10,4,5,9,8,7,7,7,4,5,56,53,109,11,16,10.0917431192661,14.6788990825688,48.6238532110092,51.3761467889908
"219","42","3",2,5,8,3,9,11,7,2,5,7,12,6,2,7,2,4,49,46,95,6,23,6.31578947368421,24.2105263157895,48.4210526315789,51.5789473684211
"220","42","4",3,5,7,3,6,12,4,3,5,4,11,4,3,3,2,7,43,42,85,10,23,11.7647058823529,27.0588235294118,49.4117647058824,50.5882352941176
"221","42","5",1,1,6,1,5,14,3,4,1,6,13,6,2,5,4,2,37,40,77,3,27,3.8961038961039,35.0649350649351,51.9480519480519,48.0519480519481
"222","42","6",3,2,5,7,8,5,8,4,2,10,8,5,3,8,3,26,42,68,110,29,13,26.3636363636364,11.8181818181818,61.8181818181818,38.1818181818182
"223","43","1",13,9,4,10,7,1,10,4,9,5,4,4,7,7,5,4,59,47,106,17,5,16.0377358490566,4.71698113207547,44.3396226415094,55.6603773584906
"224","43","2",1,1,4,3,5,14,3,6,1,6,14,6,2,6,6,7,38,50,88,8,28,9.09090909090909,31.8181818181818,56.8181818181818,43.1818181818182
"225","43","3",1,3,6,1,7,11,2,3,3,4,12,4,0,5,3,5,35,38,73,6,23,8.21917808219178,31.5068493150685,52.0547945205479,47.9452054794521
"226","43","4",3,5,4,6,5,7,10,2,5,5,8,6,5,7,2,1,43,41,84,4,15,4.76190476190476,17.8571428571429,48.8095238095238,51.1904761904762
"227","43","5",0,2,8,2,5,9,6,2,2,7,6,6,4,4,2,1,35,34,69,1,15,1.44927536231884,21.7391304347826,49.2753623188406,50.7246376811594
"228","43","6",0,2,4,5,7,5,6,4,2,7,8,4,3,7,4,1,35,37,72,1,13,1.38888888888889,18.0555555555556,51.3888888888889,48.6111111111111
"229","44","1",4,4,7,8,6,12,5,7,4,11,11,4,9,2,6,8,53,58,111,12,23,10.8108108108108,20.7207207207207,52.2522522522523,47.7477477477477
"230","44","2",4,4,3,8,4,0,5,6,4,6,1,3,6,4,6,3,35,35,70,7,1,10,1.42857142857143,50,50
"231","44","3",9,3,4,2,3,6,2,3,3,2,5,3,2,2,3,3,33,25,58,12,11,20.6896551724138,18.9655172413793,43.1034482758621,56.8965517241379
"232","44","4",0,0,1,0,2,5,2,1,0,1,6,3,0,4,2,1,13,18,31,1,11,3.2258064516129,35.4838709677419,58.0645161290323,41.9354838709677
"233","44","5",0,0,2,1,1,4,2,2,0,3,3,3,2,3,2,5,13,23,36,5,7,13.8888888888889,19.4444444444444,63.8888888888889,36.1111111111111
"234","44","6",0,0,1,0,1,3,2,2,0,1,3,3,0,3,2,2,10,16,26,2,6,7.69230769230769,23.0769230769231,61.5384615384615,38.4615384615385
"235","45","1",17,9,14,5,13,13,7,4,9,10,12,6,5,5,4,4,83,57,140,21,25,15,17.8571428571429,40.7142857142857,59.2857142857143
"236","45","2",2,3,3,6,2,12,5,9,3,5,12,8,6,8,9,3,44,55,99,5,24,5.05050505050505,24.2424242424242,55.5555555555556,44.4444444444444
"237","45","3",1,1,3,4,5,7,3,4,1,6,9,2,2,5,4,4,29,35,64,5,16,7.8125,25,54.6875,45.3125
"238","45","4",2,2,5,0,3,13,1,2,2,3,11,3,1,2,2,0,29,26,55,2,24,3.63636363636364,43.6363636363636,47.2727272727273,52.7272727272727
"239","45","5",1,1,3,4,1,8,5,3,1,6,6,4,5,3,3,0,27,30,57,1,14,1.75438596491228,24.5614035087719,52.6315789473684,47.3684210526316
"240","45","6",0,1,4,2,4,8,2,3,1,5,7,3,2,2,2,3,24,28,52,3,15,5.76923076923077,28.8461538461538,53.8461538461538,46.1538461538462
"241","46","1",1,4,9,4,6,15,7,7,4,10,11,10,8,6,7,3,55,60,115,4,26,3.47826086956522,22.6086956521739,52.1739130434783,47.8260869565217
"242","46","2",6,3,5,1,6,9,9,1,3,4,9,9,1,9,1,0,42,37,79,6,18,7.59493670886076,22.7848101265823,46.8354430379747,53.1645569620253
"243","46","3",0,0,2,1,2,4,2,0,0,3,4,1,0,2,0,0,12,12,24,0,8,0,33.3333333333333,50,50
"244","46","4",2,1,0,1,1,7,1,0,1,0,9,0,0,1,0,0,15,12,27,2,16,7.40740740740741,59.2592592592593,44.4444444444444,55.5555555555556
"245","46","5",0,0,0,1,0,6,0,2,0,1,6,1,0,2,2,2,10,16,26,2,12,7.69230769230769,46.1538461538462,61.5384615384615,38.4615384615385
"246","46","6",0,0,0,0,0,3,0,0,0,0,3,1,0,0,0,0,4,6,10,0,6,0,60,60,40
"247","49","1",7,3,6,6,7,11,9,2,3,9,12,5,5,6,2,0,53,43,96,7,23,7.29166666666667,23.9583333333333,44.7916666666667,55.2083333333333
"248","49","2",4,5,4,3,4,9,6,3,6,2,8,6,4,5,3,3,41,37,78,7,17,8.97435897435897,21.7948717948718,47.4358974358974,52.5641025641026
"249","49","3",2,6,6,5,7,3,6,3,7,5,4,3,5,4,3,5,41,36,77,7,7,9.09090909090909,9.09090909090909,46.7532467532468,53.2467532467532
"250","49","4",4,3,6,1,5,12,2,2,3,4,10,3,2,2,2,1,36,29,65,5,22,7.69230769230769,33.8461538461538,44.6153846153846,55.3846153846154
"251","49","5",2,3,4,5,4,12,7,1,4,6,12,3,6,2,1,5,41,39,80,7,24,8.75,30,48.75,51.25
"252","49","6",1,1,4,1,2,15,5,1,1,3,13,5,2,3,1,0,31,30,61,1,28,1.63934426229508,45.9016393442623,49.1803278688525,50.8196721311475
"253","5","1",3,5,4,4,5,7,5,8,5,3,8,9,3,10,8,7,42,55,97,10,15,10.3092783505155,15.4639175257732,56.701030927835,43.298969072165
"254","5","2",1,4,3,3,3,2,6,4,4,1,2,8,2,8,4,4,27,35,62,5,4,8.06451612903226,6.45161290322581,56.4516129032258,43.5483870967742
"255","5","3",1,2,2,3,0,2,3,3,2,3,1,3,4,2,3,2,18,21,39,3,3,7.69230769230769,7.69230769230769,53.8461538461538,46.1538461538462
"256","5","4",14,6,6,1,7,0,1,0,6,2,0,0,1,0,0,0,37,10,47,14,0,29.7872340425532,0,21.2765957446809,78.7234042553192
"257","5","5",0,1,2,1,1,4,2,0,0,2,4,1,1,1,0,0,13,10,23,0,8,0,34.7826086956522,43.4782608695652,56.5217391304348
"258","5","6",0,0,0,2,1,6,1,2,0,2,7,0,1,2,2,1,13,17,30,1,13,3.33333333333333,43.3333333333333,56.6666666666667,43.3333333333333
"259","50","1",4,5,6,8,4,12,10,4,5,9,10,6,10,4,4,3,55,52,107,7,22,6.54205607476636,20.5607476635514,48.5981308411215,51.4018691588785
"260","50","2",3,3,9,4,10,16,4,3,3,9,17,4,2,5,3,5,53,50,103,8,33,7.76699029126214,32.0388349514563,48.5436893203884,51.4563106796116
"261","50","3",0,1,5,2,5,15,4,2,1,6,15,4,2,5,2,0,35,37,72,0,30,0,41.6666666666667,51.3888888888889,48.6111111111111
"262","50","4",5,2,6,5,7,10,4,6,1,9,11,6,3,7,6,2,46,47,93,7,21,7.52688172043011,22.5806451612903,50.5376344086022,49.4623655913978
"263","50","5",38,10,12,5,13,6,5,2,11,7,7,2,4,3,2,0,94,36,130,38,13,29.2307692307692,10,27.6923076923077,72.3076923076923
"264","50","6",37,11,13,4,13,5,3,1,11,6,5,0,4,0,1,0,90,27,117,37,10,31.6239316239316,8.54700854700855,23.0769230769231,76.9230769230769
"265","51","1",26,11,15,5,16,11,6,2,11,10,12,3,4,4,2,2,94,49,143,28,23,19.5804195804196,16.0839160839161,34.2657342657343,65.7342657342657
"266","51","2",4,6,7,3,8,5,4,4,6,4,6,5,2,6,4,1,42,36,78,5,11,6.41025641025641,14.1025641025641,46.1538461538462,53.8461538461538
"267","51","3",1,2,4,2,4,4,4,1,2,4,4,2,3,2,1,1,24,20,44,2,8,4.54545454545455,18.1818181818182,45.4545454545455,54.5454545454545
"268","51","4",2,1,2,6,3,4,5,3,1,6,6,2,4,4,3,2,28,29,57,4,10,7.01754385964912,17.5438596491228,50.8771929824561,49.1228070175439
"269","51","5",11,6,5,3,6,2,4,2,6,3,3,2,3,3,2,0,41,23,64,11,5,17.1875,7.8125,35.9375,64.0625
"270","51","6",0,2,6,2,6,18,4,1,2,6,18,3,2,3,1,1,40,38,78,1,36,1.28205128205128,46.1538461538462,48.7179487179487,51.2820512820513
"271","52","1",11,4,6,6,5,7,6,4,4,7,6,4,7,3,4,3,51,39,90,14,13,15.5555555555556,14.4444444444444,43.3333333333333,56.6666666666667
"272","52","2",9,5,8,5,10,7,5,2,5,8,9,2,3,4,2,4,52,39,91,13,16,14.2857142857143,17.5824175824176,42.8571428571429,57.1428571428571
"273","52","3",3,2,4,4,4,8,6,4,2,6,8,6,4,6,4,4,37,41,78,7,16,8.97435897435897,20.5128205128205,52.5641025641026,47.4358974358974
"274","52","4",1,1,1,3,3,19,1,4,1,3,22,2,1,5,4,0,35,39,74,1,41,1.35135135135135,55.4054054054054,52.7027027027027,47.2972972972973
"275","52","5",4,3,2,5,4,2,1,5,3,4,4,0,3,2,4,11,26,34,60,15,6,25,10,56.6666666666667,43.3333333333333
"276","52","6",1,2,3,2,2,3,2,2,2,3,2,2,2,1,1,7,17,23,40,8,5,20,12.5,57.5,42.5
"277","53","1",2,4,8,2,5,15,5,6,4,6,12,9,5,6,6,3,48,53,101,5,27,4.95049504950495,26.7326732673267,52.4752475247525,47.5247524752475
"278","53","2",2,4,6,4,6,6,6,5,4,6,6,8,4,8,5,9,40,52,92,11,12,11.9565217391304,13.0434782608696,56.5217391304348,43.4782608695652
"279","53","3",7,6,4,6,5,2,1,6,6,5,2,1,6,1,6,3,39,31,70,10,4,14.2857142857143,5.71428571428571,44.2857142857143,55.7142857142857
"280","53","4",4,4,4,5,5,5,6,3,4,5,6,4,3,6,3,2,37,35,72,6,11,8.33333333333333,15.2777777777778,48.6111111111111,51.3888888888889
"281","53","5",0,1,4,2,2,9,3,6,1,5,7,7,4,4,5,11,27,47,74,11,16,14.8648648648649,21.6216216216216,63.5135135135135,36.4864864864865
"282","53","6",0,0,2,2,2,6,3,8,0,4,6,9,2,8,8,9,24,48,72,9,12,12.5,16.6666666666667,66.6666666666667,33.3333333333333
"283","54","1",4,4,9,2,4,17,8,7,4,7,12,13,7,8,7,5,57,64,121,9,29,7.43801652892562,23.9669421487603,52.8925619834711,47.1074380165289
"284","54","2",2,3,5,5,4,7,6,8,3,7,6,9,5,8,7,10,40,58,98,12,13,12.2448979591837,13.265306122449,59.1836734693878,40.8163265306122
"285","54","3",5,5,4,4,5,6,3,1,4,3,7,0,2,2,1,1,34,22,56,6,13,10.7142857142857,23.2142857142857,39.2857142857143,60.7142857142857
"286","54","4",0,0,0,1,1,21,1,1,0,1,23,1,0,3,2,1,27,32,59,1,44,1.69491525423729,74.5762711864407,54.2372881355932,45.7627118644068
"287","54","5",0,0,1,3,3,5,4,1,0,4,7,1,1,4,1,1,18,21,39,1,12,2.56410256410256,30.7692307692308,53.8461538461538,46.1538461538462
"288","54","6",0,0,1,1,2,9,2,1,0,2,11,2,0,3,1,1,18,21,39,1,20,2.56410256410256,51.2820512820513,53.8461538461538,46.1538461538462
"289","57","1",0,2,1,6,4,6,6,4,2,5,9,4,3,7,4,8,31,43,74,8,15,10.8108108108108,20.2702702702703,58.1081081081081,41.8918918918919
"290","57","2",6,5,2,9,3,4,5,12,6,5,5,8,8,9,12,19,49,72,121,25,9,20.6611570247934,7.43801652892562,59.504132231405,40.495867768595
"291","57","3",3,6,3,4,4,4,5,7,6,2,5,8,4,8,7,6,38,47,85,9,9,10.5882352941176,10.5882352941176,55.2941176470588,44.7058823529412
"292","57","4",6,5,7,3,5,10,2,4,5,4,8,3,4,2,4,2,43,34,77,8,18,10.3896103896104,23.3766233766234,44.1558441558442,55.8441558441558
"293","57","5",2,3,2,1,3,20,2,1,3,0,21,2,0,3,1,2,36,33,69,4,41,5.79710144927536,59.4202898550725,47.8260869565217,52.1739130434783
"294","57","6",0,1,1,2,1,4,4,5,1,3,3,7,3,6,5,9,20,38,58,9,7,15.5172413793103,12.0689655172414,65.5172413793103,34.4827586206897
"295","58","1",1,2,7,4,6,19,4,5,2,9,18,5,6,4,5,4,50,54,104,5,37,4.80769230769231,35.5769230769231,51.9230769230769,48.0769230769231
"296","58","2",2,2,5,2,2,11,4,4,2,5,9,5,5,3,4,12,34,46,80,14,20,17.5,25,57.5,42.5
"297","58","3",2,2,4,2,5,15,4,0,2,5,16,2,2,3,1,0,36,32,68,2,31,2.94117647058824,45.5882352941176,47.0588235294118,52.9411764705882
"298","58","4",1,2,3,5,4,4,5,4,2,6,5,4,4,5,4,4,30,35,65,5,9,7.69230769230769,13.8461538461538,53.8461538461538,46.1538461538462
"299","58","5",0,2,5,0,3,15,3,3,2,3,13,6,2,4,3,1,32,36,68,1,28,1.47058823529412,41.1764705882353,52.9411764705882,47.0588235294118
"300","58","6",1,1,3,3,1,11,4,4,1,5,10,5,5,4,4,8,30,43,73,9,21,12.3287671232877,28.7671232876712,58.9041095890411,41.0958904109589
"301","6","1",3,2,5,6,6,24,11,3,2,9,25,8,5,9,3,5,62,67,129,8,49,6.2015503875969,37.984496124031,51.937984496124,48.062015503876
"302","6","2",2,1,8,2,3,21,9,0,1,9,16,7,7,2,0,0,47,44,91,2,37,2.1978021978022,40.6593406593407,48.3516483516484,51.6483516483516
"303","6","3",0,0,2,2,2,5,5,0,0,5,5,2,3,2,0,0,18,18,36,0,10,0,27.7777777777778,50,50
"304","6","4",0,0,2,0,2,7,3,1,0,2,8,3,0,4,1,1,17,20,37,1,15,2.7027027027027,40.5405405405405,54.0540540540541,45.9459459459459
"305","6","5",0,0,0,0,0,23,0,0,0,0,24,0,0,0,0,0,25,25,50,0,47,0,94,50,50
"306","6","6",1,2,1,4,4,9,2,4,2,3,12,2,1,5,4,15,28,46,74,16,21,21.6216216216216,28.3783783783784,62.1621621621622,37.8378378378378
"307","61","1",14,9,16,2,15,12,4,5,9,8,11,7,2,7,5,2,78,53,131,16,23,12.2137404580153,17.5572519083969,40.4580152671756,59.5419847328244
"308","61","2",1,3,9,3,10,13,4,4,3,10,14,5,3,6,4,1,49,47,96,2,27,2.08333333333333,28.125,48.9583333333333,51.0416666666667
"309","61","3",6,2,1,3,1,20,4,7,2,2,20,8,3,7,6,7,44,58,102,13,40,12.7450980392157,39.2156862745098,56.8627450980392,43.1372549019608
"310","61","4",9,6,6,4,6,6,6,2,6,4,6,4,4,4,2,0,46,32,78,9,12,11.5384615384615,15.3846153846154,41.025641025641,58.974358974359
"311","61","5",8,6,4,5,5,7,4,3,7,3,8,2,5,3,3,1,45,32,77,9,15,11.6883116883117,19.4805194805195,41.5584415584416,58.4415584415584
"312","61","6",0,3,0,6,1,4,5,6,3,2,5,5,4,6,5,5,25,38,63,5,9,7.93650793650794,14.2857142857143,60.3174603174603,39.6825396825397
"313","62","1",3,4,3,6,7,11,6,8,4,5,15,8,2,12,8,1,50,56,106,4,26,3.77358490566038,24.5283018867925,52.8301886792453,47.1698113207547
"314","62","2",1,6,7,10,10,4,6,8,6,11,7,4,7,8,8,5,53,58,111,6,11,5.40540540540541,9.90990990990991,52.2522522522523,47.7477477477477
"315","62","3",12,8,11,5,10,10,5,3,8,8,9,3,6,2,3,4,66,44,110,16,19,14.5454545454545,17.2727272727273,40,60
"316","62","4",52,10,12,3,10,5,3,2,10,5,4,2,5,1,3,2,99,33,132,54,9,40.9090909090909,6.81818181818182,25,75
"317","62","5",73,8,8,0,8,1,1,0,8,1,1,1,1,1,0,0,101,14,115,73,2,63.4782608695652,1.73913043478261,12.1739130434783,87.8260869565217
"318","62","6",114,5,5,1,6,2,1,0,6,1,3,0,1,0,0,0,137,11,148,114,5,77.027027027027,3.37837837837838,7.43243243243243,92.5675675675676
"319","65","1",1,5,5,8,5,9,4,10,5,8,9,6,7,6,9,7,47,60,107,8,18,7.47663551401869,16.8224299065421,56.0747663551402,43.9252336448598
"320","65","2",3,6,10,5,13,11,6,4,7,9,14,4,3,7,4,5,61,53,114,8,25,7.01754385964912,21.9298245614035,46.4912280701754,53.5087719298246
"321","65","3",2,3,10,4,9,21,4,3,3,11,19,3,5,2,3,2,57,50,107,4,40,3.73831775700935,37.3831775700935,46.7289719626168,53.2710280373832
"322","65","4",2,4,8,4,6,16,3,8,3,8,14,7,5,6,8,12,52,65,117,14,30,11.965811965812,25.6410256410256,55.5555555555556,44.4444444444444
"323","65","5",0,1,5,2,3,8,5,2,1,6,6,4,4,3,2,2,27,30,57,2,14,3.50877192982456,24.5614035087719,52.6315789473684,47.3684210526316
"324","65","6",4,4,2,5,5,17,4,8,4,3,19,7,2,9,7,11,49,65,114,15,36,13.1578947368421,31.5789473684211,57.0175438596491,42.9824561403509
"325","66","1",0,0,0,0,0,0,0,2,0,0,0,2,0,1,1,0,2,7,9,0,0,0,0,77.7777777777778,22.2222222222222
"326","66","2",0,0,0,2,1,6,2,2,0,2,7,2,1,3,2,5,15,23,38,5,13,13.1578947368421,34.2105263157895,60.5263157894737,39.4736842105263
"327","66","3",0,0,1,0,0,9,1,2,0,1,8,3,1,2,2,18,13,38,51,18,17,35.2941176470588,33.3333333333333,74.5098039215686,25.4901960784314
"328","66","4",0,2,3,1,2,9,2,2,2,2,8,2,2,1,2,1,22,22,44,1,17,2.27272727272727,38.6363636363636,50,50
"329","66","5",0,0,2,0,0,8,2,1,0,2,6,2,2,0,0,3,13,18,31,3,14,9.67741935483871,45.1612903225806,58.0645161290323,41.9354838709677
"330","66","6",0,0,2,0,0,6,2,2,0,2,4,4,2,2,2,2,13,20,33,2,10,6.06060606060606,30.3030303030303,60.6060606060606,39.3939393939394
"331","67","1",11,7,10,5,7,19,8,4,7,8,17,7,8,4,4,2,73,58,131,13,36,9.9236641221374,27.4809160305344,44.2748091603053,55.7251908396947
"332","67","2",5,4,6,7,9,14,7,3,4,9,18,3,4,6,3,3,57,51,108,8,32,7.40740740740741,29.6296296296296,47.2222222222222,52.7777777777778
"333","67","3",4,4,7,3,7,10,3,6,4,6,11,6,2,7,6,4,46,47,93,8,21,8.60215053763441,22.5806451612903,50.5376344086022,49.4623655913978
"334","67","4",6,4,9,3,9,7,4,3,4,8,7,4,3,3,2,2,45,36,81,8,14,9.87654320987654,17.2839506172839,44.4444444444444,55.5555555555556
"335","67","5",9,3,1,5,1,1,7,1,3,3,1,3,5,3,1,0,29,21,50,9,2,18,4,42,58
"336","67","6",5,4,9,2,6,4,5,0,4,7,1,3,5,1,0,0,36,23,59,5,5,8.47457627118644,8.47457627118644,38.9830508474576,61.0169491525424
"337","68","1",1,4,7,3,7,11,4,7,4,6,11,8,3,8,7,8,46,56,102,9,22,8.82352941176471,21.5686274509804,54.9019607843137,45.0980392156863
"338","68","2",3,2,6,2,5,14,1,6,2,6,13,4,3,4,6,11,40,51,91,14,27,15.3846153846154,29.6703296703297,56.043956043956,43.956043956044
"339","68","3",1,3,4,3,5,6,5,7,4,4,7,9,3,10,7,8,37,52,89,9,13,10.1123595505618,14.6067415730337,58.4269662921348,41.5730337078652
"340","68","4",0,0,4,1,1,14,4,4,0,5,11,7,4,3,4,3,29,39,68,3,25,4.41176470588235,36.7647058823529,57.3529411764706,42.6470588235294
"341","68","5",0,1,1,4,2,6,6,2,1,5,7,4,4,4,2,1,24,29,53,1,13,1.88679245283019,24.5283018867925,54.7169811320755,45.2830188679245
"342","68","6",0,1,1,3,1,5,5,7,1,3,5,9,3,9,6,6,23,45,68,6,10,8.82352941176471,14.7058823529412,66.1764705882353,33.8235294117647
"343","69","1",15,5,4,5,3,3,6,1,5,4,2,2,6,1,1,0,44,22,66,15,5,22.7272727272727,7.57575757575758,33.3333333333333,66.6666666666667
"344","69","2",0,1,1,1,1,5,2,3,1,1,6,4,1,5,4,6,16,29,45,6,11,13.3333333333333,24.4444444444444,64.4444444444444,35.5555555555556
"345","69","3",2,3,2,2,4,3,1,2,4,1,5,0,1,2,2,1,22,16,38,3,8,7.89473684210526,21.0526315789474,42.1052631578947,57.8947368421053
"346","69","4",5,3,2,1,2,1,1,0,3,0,1,0,1,0,0,0,18,5,23,5,2,21.7391304347826,8.69565217391304,21.7391304347826,78.2608695652174
"347","69","5",2,1,1,0,1,1,1,1,1,0,1,2,1,2,1,3,10,12,22,5,2,22.7272727272727,9.09090909090909,54.5454545454545,45.4545454545455
"348","69","6",1,1,0,2,0,0,1,2,1,1,0,0,3,0,2,5,9,13,22,6,0,27.2727272727273,0,59.0909090909091,40.9090909090909
"349","7","1",1,5,8,3,5,9,11,4,5,6,6,12,7,9,5,6,48,57,105,7,15,6.66666666666667,14.2857142857143,54.2857142857143,45.7142857142857
"350","7","2",5,6,6,5,4,6,3,9,6,5,4,7,7,5,9,9,44,55,99,14,10,14.1414141414141,10.1010101010101,55.5555555555556,44.4444444444444
"351","7","3",0,1,1,3,1,0,2,10,1,3,0,9,3,9,10,22,18,60,78,22,0,28.2051282051282,0,76.9230769230769,23.0769230769231
"352","7","4",0,1,0,1,0,1,2,6,1,0,1,7,2,7,7,22,13,48,61,22,2,36.0655737704918,3.27868852459016,78.6885245901639,21.3114754098361
"353","7","5",0,1,0,4,1,3,0,6,1,3,4,3,3,4,7,17,16,44,60,17,7,28.3333333333333,11.6666666666667,73.3333333333333,26.6666666666667
"354","7","6",1,1,2,0,1,8,0,5,1,1,7,5,1,4,5,16,19,42,61,17,15,27.8688524590164,24.5901639344262,68.8524590163934,31.1475409836066
"355","70","1",1,2,4,0,1,13,1,5,2,2,11,6,3,4,6,7,29,42,71,8,24,11.2676056338028,33.8028169014084,59.1549295774648,40.8450704225352
"356","70","2",0,0,1,0,2,2,2,0,1,1,3,2,0,3,1,0,10,11,21,0,5,0,23.8095238095238,52.3809523809524,47.6190476190476
"357","70","3",0,1,1,1,1,0,1,0,1,1,0,0,1,0,0,0,6,5,11,0,0,0,0,45.4545454545455,54.5454545454545
"358","70","4",0,2,2,0,1,2,0,0,1,0,1,0,0,0,0,0,8,4,12,0,3,0,25,33.3333333333333,66.6666666666667
"359","70","5",1,1,2,0,1,4,1,2,1,1,4,2,1,2,2,0,14,14,28,1,8,3.57142857142857,28.5714285714286,50,50
"360","70","6",2,1,2,0,1,5,2,0,1,1,4,2,1,1,0,0,14,12,26,2,9,7.69230769230769,34.6153846153846,46.1538461538462,53.8461538461538
"361","71","1",11,7,7,8,11,2,7,3,7,9,5,2,5,5,3,2,58,39,97,13,7,13.4020618556701,7.21649484536082,40.2061855670103,59.7938144329897
"362","71","2",9,13,10,9,10,2,6,4,12,6,2,2,8,2,4,3,64,41,105,12,4,11.4285714285714,3.80952380952381,39.0476190476191,60.9523809523809
"363","71","3",1,4,6,5,6,12,5,3,3,7,12,3,4,4,3,1,43,39,82,2,24,2.4390243902439,29.2682926829268,47.5609756097561,52.4390243902439
"364","71","4",11,6,6,2,6,8,4,1,6,2,8,3,2,3,1,0,45,27,72,11,16,15.2777777777778,22.2222222222222,37.5,62.5
"365","71","5",7,4,4,3,5,2,3,2,4,3,2,2,3,2,2,1,32,20,52,8,4,15.3846153846154,7.69230769230769,38.4615384615385,61.5384615384615
"366","71","6",0,3,2,4,4,0,2,3,3,4,1,1,3,2,3,2,20,20,40,2,1,5,2.5,50,50
"367","72","1",15,8,10,5,9,15,6,2,8,6,14,3,6,2,2,0,72,42,114,15,29,13.1578947368421,25.4385964912281,36.8421052631579,63.1578947368421
"368","72","2",4,3,4,2,2,11,6,4,3,3,9,8,3,7,4,0,37,39,76,4,20,5.26315789473684,26.3157894736842,51.3157894736842,48.6842105263158
"369","72","3",0,2,3,3,1,10,6,2,2,4,7,5,6,2,2,1,29,30,59,1,17,1.69491525423729,28.8135593220339,50.8474576271186,49.1525423728814
"370","72","4",3,6,7,6,8,3,6,7,6,7,3,7,5,8,7,7,47,52,99,10,6,10.1010101010101,6.06060606060606,52.5252525252525,47.4747474747475
"371","72","5",1,3,4,1,4,6,6,3,3,3,6,7,2,7,3,4,30,36,66,5,12,7.57575757575758,18.1818181818182,54.5454545454545,45.4545454545455
"372","72","6",0,2,5,2,4,11,2,4,2,5,11,4,3,3,4,1,32,34,66,1,22,1.51515151515152,33.3333333333333,51.5151515151515,48.4848484848485
"373","73","1",5,4,5,4,5,9,6,2,5,5,9,3,5,3,2,1,43,33,76,6,18,7.89473684210526,23.6842105263158,43.4210526315789,56.5789473684211
"374","73","2",2,1,6,0,7,19,1,0,1,5,19,1,0,1,0,0,38,28,66,2,38,3.03030303030303,57.5757575757576,42.4242424242424,57.5757575757576
"375","73","3",10,4,4,2,4,7,4,1,5,2,7,2,3,2,1,0,39,22,61,10,14,16.3934426229508,22.9508196721311,36.0655737704918,63.9344262295082
"376","73","4",10,4,5,1,6,2,1,0,5,2,3,0,0,1,0,0,32,11,43,10,5,23.2558139534884,11.6279069767442,25.5813953488372,74.4186046511628
"377","73","5",3,2,5,0,3,2,2,0,2,3,0,2,2,0,0,0,19,10,29,3,2,10.3448275862069,6.89655172413793,34.4827586206897,65.5172413793103
"378","73","6",1,2,3,1,3,1,1,0,2,2,1,0,0,0,0,0,13,7,20,1,2,5,10,35,65
"379","74","1",2,3,2,3,1,4,1,5,3,2,3,3,3,2,5,3,22,26,48,5,7,10.4166666666667,14.5833333333333,54.1666666666667,45.8333333333333
"380","74","2",1,1,1,2,1,4,3,3,1,2,3,4,2,4,3,0,17,21,38,1,7,2.63157894736842,18.4210526315789,55.2631578947368,44.7368421052632
"381","74","3",7,5,3,3,3,4,2,2,5,1,4,1,3,1,2,1,31,19,50,8,8,16,16,38,62
"382","74","4",2,2,3,2,2,4,4,2,2,3,3,4,3,3,2,3,24,23,47,5,7,10.6382978723404,14.8936170212766,48.936170212766,51.063829787234
"383","74","5",8,1,0,2,1,2,2,2,1,1,3,2,2,3,3,7,20,23,43,15,5,34.8837209302326,11.6279069767442,53.4883720930233,46.5116279069767
"384","74","6",11,3,4,1,2,4,2,0,2,2,2,1,2,0,0,0,28,11,39,11,6,28.2051282051282,15.3846153846154,28.2051282051282,71.7948717948718
"385","77","1",1,2,5,4,4,11,8,4,3,7,10,7,6,6,4,4,42,47,89,5,21,5.61797752808989,23.5955056179775,52.8089887640449,47.1910112359551
"386","77","2",1,1,2,3,4,9,8,4,2,4,11,9,2,10,4,3,35,45,80,4,20,5,25,56.25,43.75
"387","77","3",2,2,1,1,2,5,3,2,2,1,6,4,1,5,3,4,20,27,47,6,11,12.7659574468085,23.4042553191489,57.4468085106383,42.5531914893617
"388","77","4",3,3,5,2,5,2,1,1,3,3,2,0,2,0,1,2,24,14,38,5,4,13.1578947368421,10.5263157894737,36.8421052631579,63.1578947368421
"389","77","5",0,4,3,2,3,1,3,2,5,1,1,3,3,2,2,1,21,18,39,1,2,2.56410256410256,5.12820512820513,46.1538461538462,53.8461538461538
"390","77","6",2,2,5,1,4,12,2,3,2,4,11,4,1,3,2,0,31,30,61,2,23,3.27868852459016,37.7049180327869,49.1803278688525,50.8196721311475
"391","78","1",2,3,6,1,3,8,1,5,3,5,5,5,5,2,5,2,31,33,64,4,13,6.25,20.3125,51.5625,48.4375
"392","78","2",0,1,0,2,0,7,3,4,1,1,7,5,2,5,4,4,18,31,49,4,14,8.16326530612245,28.5714285714286,63.265306122449,36.734693877551
"393","78","3",0,0,1,0,0,6,3,1,0,1,4,4,1,3,1,0,12,16,28,0,10,0,35.7142857142857,57.1428571428571,42.8571428571429
"394","78","4",3,2,0,5,3,2,4,2,2,4,4,1,3,3,2,1,23,21,44,4,6,9.09090909090909,13.6363636363636,47.7272727272727,52.2727272727273
"395","78","5",4,2,2,4,3,4,2,2,2,4,5,0,3,1,2,1,26,18,44,5,9,11.3636363636364,20.4545454545455,40.9090909090909,59.0909090909091
"396","78","6",3,2,1,2,0,2,0,2,2,1,1,0,2,0,2,1,13,11,24,4,3,16.6666666666667,12.5,45.8333333333333,54.1666666666667
"397","8","1",8,7,10,5,9,11,5,6,7,8,10,6,6,5,6,2,63,51,114,10,21,8.7719298245614,18.4210526315789,44.7368421052632,55.2631578947368
"398","8","2",1,2,6,1,6,13,3,3,2,5,13,4,1,5,3,0,36,35,71,1,26,1.40845070422535,36.6197183098592,49.2957746478873,50.7042253521127
"399","8","3",1,2,6,3,5,17,5,0,2,7,17,2,3,2,0,0,41,34,75,1,34,1.33333333333333,45.3333333333333,45.3333333333333,54.6666666666667
"400","8","4",1,3,7,2,6,14,3,1,3,6,14,2,2,2,1,0,39,31,70,1,28,1.42857142857143,40,44.2857142857143,55.7142857142857
"401","8","5",4,4,5,5,6,10,9,4,4,6,10,8,4,8,4,1,48,47,95,5,20,5.26315789473684,21.0526315789474,49.4736842105263,50.5263157894737
"402","8","6",15,7,7,3,4,3,5,3,7,3,0,5,5,2,3,1,48,28,76,16,3,21.0526315789474,3.94736842105263,36.8421052631579,63.1578947368421
"403","81","1",3,3,2,4,3,7,1,6,3,3,8,3,3,4,6,14,30,46,76,17,15,22.3684210526316,19.7368421052632,60.5263157894737,39.4736842105263
"404","81","2",2,1,3,1,3,3,1,2,2,3,3,2,2,2,3,4,19,21,40,6,6,15,15,52.5,47.5
"405","81","3",0,0,0,1,0,3,1,3,0,1,4,2,1,3,3,4,10,19,29,4,7,13.7931034482759,24.1379310344828,65.5172413793103,34.4827586206897
"406","81","4",3,2,1,1,0,1,1,2,2,0,0,2,2,1,2,0,13,10,23,3,1,13.0434782608696,4.34782608695652,43.4782608695652,56.5217391304348
"407","81","5",0,0,1,0,0,5,1,0,0,1,4,1,1,0,0,0,8,9,17,0,9,0,52.9411764705882,52.9411764705882,47.0588235294118
"408","81","6",0,0,0,0,0,0,0,1,0,0,0,0,1,0,1,7,3,10,13,7,0,53.8461538461538,0,76.9230769230769,23.0769230769231
"409","82","1",13,9,6,5,4,3,7,3,8,2,1,5,6,3,3,2,51,32,83,15,4,18.0722891566265,4.81927710843374,38.5542168674699,61.4457831325301
"410","82","2",9,3,4,1,3,2,1,1,3,2,1,2,2,1,2,4,25,19,44,13,3,29.5454545454545,6.81818181818182,43.1818181818182,56.8181818181818
"411","82","3",0,3,4,2,3,5,3,0,3,4,4,1,3,0,0,0,22,16,38,0,9,0,23.6842105263158,42.1052631578947,57.8947368421053
"412","82","4",2,2,2,1,2,11,1,0,2,1,10,0,1,0,0,0,22,16,38,2,21,5.26315789473684,55.2631578947368,42.1052631578947,57.8947368421053
"413","82","5",0,0,1,0,0,15,1,0,0,1,13,1,1,0,0,0,18,18,36,0,28,0,77.7777777777778,50,50
"414","82","6",0,0,0,0,0,12,0,0,0,0,12,0,0,0,0,0,14,13,27,0,24,0,88.8888888888889,48.1481481481481,51.8518518518519
"415","85","1",2,5,3,6,4,7,5,5,5,4,7,4,5,5,5,2,38,39,77,4,14,5.19480519480519,18.1818181818182,50.6493506493507,49.3506493506493
"416","85","2",6,8,4,6,6,7,2,5,8,2,8,1,4,2,4,3,44,35,79,9,15,11.3924050632911,18.9873417721519,44.3037974683544,55.6962025316456
"417","85","3",2,2,3,1,3,21,1,4,2,2,21,5,1,4,4,4,38,45,83,6,42,7.2289156626506,50.6024096385542,54.2168674698795,45.7831325301205
"418","85","4",1,1,1,4,5,15,3,2,1,4,18,1,0,4,2,6,33,38,71,7,33,9.85915492957746,46.4788732394366,53.5211267605634,46.4788732394366
"419","85","5",2,2,2,2,4,18,1,0,2,2,20,0,0,1,0,0,32,27,59,2,38,3.38983050847458,64.406779661017,45.7627118644068,54.2372881355932
"420","85","6",2,2,3,1,4,15,2,0,2,3,15,1,1,1,0,0,31,24,55,2,30,3.63636363636364,54.5454545454545,43.6363636363636,56.3636363636364
"421","86","1",7,6,6,3,7,10,5,3,6,3,11,6,2,7,3,5,48,45,93,12,21,12.9032258064516,22.5806451612903,48.3870967741936,51.6129032258064
"422","86","2",4,8,9,3,9,5,0,5,8,4,6,2,2,3,5,1,45,32,77,5,11,6.49350649350649,14.2857142857143,41.5584415584416,58.4415584415584
"423","86","3",4,4,5,5,4,17,8,3,3,6,16,6,5,5,3,1,51,47,98,5,33,5.10204081632653,33.6734693877551,47.9591836734694,52.0408163265306
"424","86","4",7,3,3,3,3,10,3,2,3,3,9,3,3,2,2,2,35,29,64,9,19,14.0625,29.6875,45.3125,54.6875
"425","86","5",1,1,2,1,1,16,3,2,1,2,15,3,2,3,2,1,28,31,59,2,31,3.38983050847458,52.5423728813559,52.5423728813559,47.4576271186441
"426","86","6",0,0,1,1,1,23,2,2,0,2,23,3,1,3,2,2,32,37,69,2,46,2.89855072463768,66.6666666666667,53.6231884057971,46.3768115942029
"427","87","1",10,5,3,4,2,7,6,2,4,3,6,4,5,3,2,1,41,29,70,11,13,15.7142857142857,18.5714285714286,41.4285714285714,58.5714285714286
"428","87","2",3,2,5,2,4,7,8,4,2,5,6,11,3,9,4,10,36,52,88,13,13,14.7727272727273,14.7727272727273,59.0909090909091,40.9090909090909
"429","87","3",0,1,4,7,5,15,6,8,1,10,15,7,6,7,7,18,46,74,120,18,30,15,25,61.6666666666667,38.3333333333333
"430","87","4",0,2,5,4,7,5,5,7,2,7,7,8,3,10,8,33,37,79,116,33,12,28.448275862069,10.3448275862069,68.1034482758621,31.8965517241379
"431","87","5",0,2,2,5,2,6,4,6,2,5,6,5,5,5,6,8,29,43,72,8,12,11.1111111111111,16.6666666666667,59.7222222222222,40.2777777777778
"432","87","6",0,1,1,0,0,14,0,2,1,0,14,2,1,1,2,4,20,26,46,4,28,8.69565217391304,60.8695652173913,56.5217391304348,43.4782608695652
"433","88","1",7,6,4,6,3,1,8,2,6,4,1,3,7,3,2,1,39,28,67,8,2,11.9402985074627,2.98507462686567,41.7910447761194,58.2089552238806
"434","88","2",5,2,2,6,4,6,4,2,1,6,8,0,3,3,2,1,32,26,58,6,14,10.3448275862069,24.1379310344828,44.8275862068966,55.1724137931034
"435","88","3",0,0,1,0,0,15,0,0,0,1,15,0,0,0,0,0,18,17,35,0,30,0,85.7142857142857,48.5714285714286,51.4285714285714
"436","88","4",0,0,1,0,0,16,1,0,0,1,16,1,1,0,0,0,20,20,40,0,32,0,80,50,50
"437","88","5",0,0,1,0,0,16,1,0,0,1,16,1,1,0,0,0,20,20,40,0,32,0,80,50,50
"438","88","6",0,0,1,0,0,12,1,1,0,1,11,2,1,0,0,0,15,18,33,0,23,0,69.6969696969697,54.5454545454545,45.4545454545455
"439","89","1",5,10,13,5,14,32,9,5,10,8,33,10,4,10,5,8,94,90,184,13,65,7.06521739130435,35.3260869565217,48.9130434782609,51.0869565217391
"440","89","2",2,4,6,3,4,47,8,5,3,5,45,10,4,8,4,3,79,85,164,5,92,3.04878048780488,56.0975609756098,51.8292682926829,48.1707317073171
"441","89","3",3,3,4,3,4,3,3,7,3,4,3,6,3,6,6,17,30,51,81,20,6,24.6913580246914,7.40740740740741,62.962962962963,37.037037037037
"442","89","4",2,3,3,4,3,9,7,7,3,4,9,10,4,9,6,7,38,55,93,9,18,9.67741935483871,19.3548387096774,59.1397849462366,40.8602150537634
"443","89","5",3,5,5,5,6,9,2,6,5,5,10,3,4,4,6,10,43,48,91,13,19,14.2857142857143,20.8791208791209,52.7472527472527,47.2527472527473
"444","89","6",0,1,0,3,2,5,2,7,1,2,6,6,1,8,7,8,21,41,62,8,11,12.9032258064516,17.741935483871,66.1290322580645,33.8709677419355
"445","9","1",3,4,6,8,7,13,6,6,4,9,14,4,6,5,5,9,53,59,112,12,27,10.7142857142857,24.1071428571429,52.6785714285714,47.3214285714286
"446","9","2",1,11,7,9,10,5,8,3,11,6,7,2,7,4,3,4,56,45,101,5,12,4.95049504950495,11.8811881188119,44.5544554455446,55.4455445544554
"447","9","3",9,5,5,5,6,7,4,3,4,5,8,2,3,4,3,0,45,31,76,9,15,11.8421052631579,19.7368421052632,40.7894736842105,59.2105263157895
"448","9","4",10,5,5,5,4,3,9,1,5,5,2,5,7,3,1,1,44,30,74,11,5,14.8648648648649,6.75675675675676,40.5405405405405,59.4594594594595
"449","9","5",25,6,5,2,5,4,4,0,5,1,4,2,1,2,0,0,52,17,69,25,8,36.231884057971,11.5942028985507,24.6376811594203,75.3623188405797
"450","9","6",6,6,7,2,6,8,4,0,6,3,8,2,2,2,0,0,41,24,65,6,16,9.23076923076923,24.6153846153846,36.9230769230769,63.0769230769231
"451","90","1",15,11,9,5,9,10,7,4,12,3,10,5,6,5,4,4,73,49,122,19,20,15.5737704918033,16.3934426229508,40.1639344262295,59.8360655737705
"452","90","2",2,6,4,13,7,8,11,9,6,11,11,7,9,10,8,3,60,68,128,5,19,3.90625,14.84375,53.125,46.875
"453","90","3",1,2,10,3,8,14,4,8,2,11,11,9,5,7,8,12,51,67,118,13,25,11.0169491525424,21.1864406779661,56.7796610169492,43.2203389830508
"454","90","4",0,0,5,1,4,17,2,7,0,6,16,8,2,7,7,5,36,54,90,5,33,5.55555555555556,36.6666666666667,60,40
"455","90","5",3,3,5,1,4,14,7,1,3,3,14,7,2,6,1,2,40,39,79,5,28,6.32911392405063,35.4430379746835,49.3670886075949,50.6329113924051
"456","90","6",4,2,5,3,5,14,8,7,2,6,14,12,3,11,6,5,48,62,110,9,28,8.18181818181818,25.4545454545455,56.3636363636364,43.6363636363636
"457","91","1",13,9,8,8,12,14,12,2,9,7,18,6,4,10,2,2,79,60,139,15,32,10.7913669064748,23.0215827338129,43.1654676258993,56.8345323741007
"458","91","2",5,7,6,5,7,6,5,7,7,4,7,7,4,8,7,5,51,49,100,10,13,10,13,49,51
"459","91","3",1,4,9,2,9,11,1,6,4,7,11,5,2,5,6,4,45,45,90,5,22,5.55555555555556,24.4444444444444,50,50
"460","91","4",4,4,4,5,7,13,6,4,4,5,15,5,3,7,4,2,49,46,95,6,28,6.31578947368421,29.4736842105263,48.4210526315789,51.5789473684211
"461","91","5",3,4,1,7,3,4,4,5,4,4,5,2,5,4,5,12,32,43,75,15,9,20,12,57.3333333333333,42.6666666666667
"462","91","6",7,4,5,4,4,1,5,3,4,5,0,5,5,4,4,5,34,34,68,12,1,17.6470588235294,1.47058823529412,50,50
"463","92","1",3,6,11,8,9,9,8,5,6,13,8,5,9,4,5,7,61,58,119,10,17,8.40336134453782,14.2857142857143,48.7394957983193,51.2605042016807
"464","92","2",4,4,6,2,6,16,1,7,4,5,16,6,3,5,7,3,48,50,98,7,32,7.14285714285714,32.6530612244898,51.0204081632653,48.9795918367347
"465","92","3",12,10,8,8,7,5,11,3,10,6,4,6,9,5,3,1,66,45,111,13,9,11.7117117117117,8.10810810810811,40.5405405405405,59.4594594594595
"466","92","4",8,10,8,5,9,8,6,5,10,3,10,6,4,8,6,7,61,55,116,15,18,12.9310344827586,15.5172413793103,47.4137931034483,52.5862068965517
"467","92","5",0,3,2,6,3,13,4,7,3,5,14,5,5,5,6,6,38,52,90,6,27,6.66666666666667,30,57.7777777777778,42.2222222222222
"468","92","6",6,7,6,2,6,8,1,2,8,1,8,1,3,0,2,0,41,23,64,6,16,9.375,25,35.9375,64.0625
"469","93","1",3,2,6,3,4,21,5,11,2,7,20,13,5,11,11,13,57,83,140,16,41,11.4285714285714,29.2857142857143,59.2857142857143,40.7142857142857
"470","93","2",1,1,4,3,5,19,6,2,1,6,21,5,2,6,2,0,43,44,87,1,40,1.14942528735632,45.9770114942529,50.5747126436782,49.4252873563218
"471","93","3",0,1,3,2,2,11,5,3,1,4,11,6,3,5,3,1,29,35,64,1,22,1.5625,34.375,54.6875,45.3125
"472","93","4",0,0,0,0,0,10,0,1,0,0,11,1,0,1,1,16,13,31,44,16,21,36.3636363636364,47.7272727272727,70.4545454545455,29.5454545454545
"473","93","5",0,1,2,1,1,4,4,0,1,2,3,3,1,3,0,0,14,15,29,0,7,0,24.1379310344828,51.7241379310345,48.2758620689655
"474","93","6",0,0,1,0,0,2,1,1,0,1,1,1,1,0,0,3,5,10,15,3,3,20,20,66.6666666666667,33.3333333333333
"475","94","1",1,2,3,4,2,5,9,4,2,5,4,8,5,7,4,8,31,45,76,9,9,11.8421052631579,11.8421052631579,59.2105263157895,40.7894736842105
"476","94","2",7,3,3,3,1,8,3,3,3,2,6,3,5,1,3,3,33,27,60,10,14,16.6666666666667,23.3333333333333,45,55
"477","94","3",0,3,2,4,2,5,4,6,3,2,5,6,3,6,5,12,26,45,71,12,10,16.9014084507042,14.0845070422535,63.3802816901408,36.6197183098592
"478","94","4",2,2,6,2,5,9,4,6,2,6,8,8,3,6,6,5,37,46,83,7,17,8.43373493975904,20.4819277108434,55.421686746988,44.578313253012
"479","94","5",1,1,2,2,3,10,3,3,1,3,11,4,1,5,3,6,26,36,62,7,21,11.2903225806452,33.8709677419355,58.0645161290323,41.9354838709677
"480","94","6",1,1,1,4,2,3,5,4,1,3,4,5,2,6,3,7,21,34,55,8,7,14.5454545454545,12.7272727272727,61.8181818181818,38.1818181818182
"481","95","1",11,12,14,5,13,18,6,2,12,7,17,3,5,2,2,0,82,50,132,11,35,8.33333333333333,26.5151515151515,37.8787878787879,62.1212121212121
"482","95","2",2,3,7,2,7,51,3,2,3,5,51,3,1,4,2,1,78,72,150,3,102,2,68,48,52
"483","95","3",6,6,7,2,7,36,4,3,5,3,36,5,1,6,3,2,72,63,135,8,72,5.92592592592593,53.3333333333333,46.6666666666667,53.3333333333333
"484","95","4",52,5,8,3,7,46,7,0,6,5,45,4,4,3,0,0,131,67,198,52,91,26.2626262626263,45.959595959596,33.8383838383838,66.1616161616162
"485","95","5",1,3,3,1,1,56,5,1,3,1,55,5,3,3,1,1,73,73,146,2,111,1.36986301369863,76.027397260274,50,50
"486","95","6",4,3,6,3,9,62,2,2,3,6,65,1,1,3,2,2,93,84,177,6,127,3.38983050847458,71.7514124293785,47.4576271186441,52.5423728813559
"487","96","1",5,7,7,4,4,11,6,6,7,4,9,8,7,5,6,3,52,50,102,8,20,7.84313725490196,19.6078431372549,49.0196078431373,50.9803921568627
"488","96","2",8,6,4,6,7,8,10,4,7,4,11,8,4,10,4,2,56,50,106,10,19,9.43396226415094,17.9245283018868,47.1698113207547,52.8301886792453
"489","96","3",10,6,11,2,10,15,4,1,6,7,15,2,3,2,1,0,61,37,98,10,30,10.2040816326531,30.6122448979592,37.7551020408163,62.2448979591837
"490","96","4",9,3,8,3,6,8,5,3,3,8,6,5,5,3,3,5,46,40,86,14,14,16.2790697674419,16.2790697674419,46.5116279069767,53.4883720930233
"491","96","5",20,8,8,3,9,5,2,1,8,4,5,0,3,0,1,0,58,22,80,20,10,25,12.5,27.5,72.5
"492","96","6",0,0,6,3,8,9,5,1,0,10,11,2,2,4,1,0,34,31,65,0,20,0,30.7692307692308,47.6923076923077,52.3076923076923
"493","97","1",25,12,14,5,16,12,7,5,12,7,14,7,3,9,5,2,98,60,158,27,26,17.0886075949367,16.4556962025316,37.9746835443038,62.0253164556962
"494","97","2",13,8,7,12,9,6,8,11,8,12,8,7,11,9,11,6,76,73,149,19,14,12.751677852349,9.39597315436242,48.993288590604,51.006711409396
"495","97","3",7,8,9,5,8,7,6,4,9,6,6,4,7,3,4,3,57,42,99,10,13,10.1010101010101,13.1313131313131,42.4242424242424,57.5757575757576
"496","97","4",8,3,2,3,4,1,2,1,4,1,3,0,1,2,1,0,27,12,39,8,4,20.5128205128205,10.2564102564103,30.7692307692308,69.2307692307692
"497","97","5",2,1,0,2,0,1,2,2,1,1,1,1,2,1,1,1,10,12,22,3,2,13.6363636363636,9.09090909090909,54.5454545454545,45.4545454545455
"498","97","6",3,3,1,4,1,8,6,8,4,2,8,10,5,9,8,3,37,49,86,6,16,6.97674418604651,18.6046511627907,56.9767441860465,43.0232558139535
"499","98","1",1,3,6,5,4,13,5,9,3,8,11,10,7,8,9,37,47,95,142,38,24,26.7605633802817,16.9014084507042,66.9014084507042,33.0985915492958
"500","98","2",0,3,2,3,2,10,0,12,3,2,11,9,2,10,12,63,34,113,147,63,21,42.8571428571429,14.2857142857143,76.8707482993197,23.1292517006803
"501","98","3",0,0,1,4,2,8,8,11,0,5,9,15,3,16,10,40,34,101,135,40,17,29.6296296296296,12.5925925925926,74.8148148148148,25.1851851851852
"502","98","4",0,0,2,0,2,11,5,12,0,2,11,18,0,18,13,35,33,99,132,35,22,26.5151515151515,16.6666666666667,75,25
"503","98","5",0,0,0,1,1,5,4,8,0,1,6,11,0,13,9,63,20,105,125,63,11,50.4,8.8,84,16
"504","98","6",0,1,1,4,1,7,2,14,1,4,7,12,4,11,13,34,30,89,119,34,14,28.5714285714286,11.7647058823529,74.7899159663866,25.2100840336134
"505","99","1",5,8,11,6,9,15,11,3,9,9,12,8,9,5,3,1,71,56,127,6,27,4.7244094488189,21.259842519685,44.0944881889764,55.9055118110236
"506","99","2",0,5,5,6,4,6,6,8,5,6,5,8,6,7,8,5,41,52,93,5,11,5.37634408602151,11.8279569892473,55.9139784946237,44.0860215053763
"507","99","3",3,5,4,6,5,13,8,4,5,5,14,6,5,7,4,3,50,50,100,6,27,6,27,50,50
"508","99","4",5,7,11,2,8,12,5,5,6,6,9,8,5,5,5,3,57,48,105,8,21,7.61904761904762,20,45.7142857142857,54.2857142857143
"509","99","5",1,2,2,4,3,11,7,4,2,4,11,7,3,8,4,2,35,43,78,3,22,3.84615384615385,28.2051282051282,55.1282051282051,44.8717948717949
"510","99","6",1,3,1,5,3,0,2,2,3,3,1,0,3,1,2,3,18,18,36,4,1,11.1111111111111,2.77777777777778,50,50
