"","fish_id","bin","LLLL","LLLR","LLRL","LLRR","LRLL","LRLR","LRRL","LRRR","RLLL","RLLR","RLRL","RLRR","RRLL","RRLR","RRRL","RRRR","L","R","total_turns","reps","alts","rel_reps","rel_alts","rel_R","rel_L"
"1","1","1",8,9,14,6,13,14,8,3,9,11,13,5,7,4,3,2,77,55,132,10,27,7.57575757575758,20.4545454545455,41.6666666666667,58.3333333333333
"2","1","2",12,9,9,3,9,13,4,6,9,3,13,7,2,7,6,5,66,54,120,17,26,14.1666666666667,21.6666666666667,45,55
"3","1","3",3,3,5,5,6,11,8,2,4,7,12,5,5,6,2,2,46,43,89,5,23,5.61797752808989,25.8426966292135,48.314606741573,51.685393258427
"4","1","4",2,4,8,1,6,18,4,2,4,5,17,4,3,3,2,5,47,44,91,7,35,7.69230769230769,38.4615384615385,48.3516483516484,51.6483516483516
"5","1","5",14,7,8,2,6,12,3,2,7,3,11,3,4,1,2,3,56,35,91,17,23,18.6813186813187,25.2747252747253,38.4615384615385,61.5384615384615
"6","1","6",27,8,8,2,8,7,4,0,8,2,7,2,2,2,0,0,67,23,90,27,14,30,15.5555555555556,25.5555555555556,74.4444444444444
"7","10","1",15,6,5,4,8,10,3,8,6,3,13,7,2,9,8,11,61,60,121,26,23,21.4876033057851,19.0082644628099,49.5867768595041,50.4132231404959
"8","10","2",0,3,5,8,8,3,7,7,3,10,7,6,5,10,7,11,43,60,103,11,10,10.6796116504854,9.70873786407767,58.252427184466,41.747572815534
"9","10","3",9,5,6,3,6,12,4,4,5,4,12,5,3,5,4,2,50,42,92,11,24,11.9565217391304,26.0869565217391,45.6521739130435,54.3478260869565
"10","10","4",3,5,8,3,8,26,6,1,5,5,26,4,2,5,1,1,61,51,112,4,52,3.57142857142857,46.4285714285714,45.5357142857143,54.4642857142857
"11","10","5",0,1,0,2,3,17,1,3,1,1,20,1,0,4,3,9,29,40,69,9,37,13.0434782608696,53.6231884057971,57.9710144927536,42.0289855072464
"12","10","6",0,0,0,2,1,1,0,6,0,2,2,4,1,4,6,27,11,48,59,27,3,45.7627118644068,5.08474576271186,81.3559322033898,18.6440677966102
"13","11","1",26,14,16,6,14,10,7,2,15,8,8,3,9,1,3,0,98,47,145,26,18,17.9310344827586,12.4137931034483,32.4137931034483,67.5862068965517
"14","11","2",50,11,11,3,10,5,4,1,11,3,4,2,4,1,1,1,98,27,125,51,9,40.8,7.2,21.6,78.4
"15","11","3",89,4,5,0,3,8,1,1,3,1,6,2,1,1,1,1,112,18,130,90,14,69.2307692307692,10.7692307692308,13.8461538461538,86.1538461538462
"16","11","4",38,7,8,0,8,1,1,1,7,1,1,2,0,2,1,0,67,14,81,38,2,46.9135802469136,2.46913580246914,17.2839506172839,82.7160493827161
"17","11","5",43,4,2,2,2,1,2,0,5,0,1,0,3,0,0,0,59,9,68,43,2,63.2352941176471,2.94117647058824,13.2352941176471,86.7647058823529
"18","11","6",59,6,7,0,7,2,0,0,6,1,2,0,0,0,0,0,84,9,93,59,4,63.4408602150538,4.3010752688172,9.67741935483871,90.3225806451613
"19","12","1",4,9,11,7,11,6,6,7,9,9,7,5,7,6,7,8,63,59,122,12,13,9.83606557377049,10.655737704918,48.3606557377049,51.6393442622951
"20","12","2",8,5,7,4,9,11,2,6,6,6,13,4,3,6,6,19,55,63,118,27,24,22.8813559322034,20.3389830508475,53.3898305084746,46.6101694915254
"21","12","3",7,6,9,7,8,9,4,9,7,10,8,6,8,5,9,6,62,59,121,13,17,10.7438016528926,14.0495867768595,48.7603305785124,51.2396694214876
"22","12","4",5,7,6,7,7,11,3,9,7,6,12,5,6,6,9,3,57,55,112,8,23,7.14285714285714,20.5357142857143,49.1071428571429,50.8928571428571
"23","12","5",23,10,9,10,11,21,13,3,10,9,22,6,8,7,3,1,101,68,169,24,43,14.2011834319527,25.4437869822485,40.2366863905325,59.7633136094675
"24","12","6",1,2,3,6,5,14,9,4,2,7,16,6,4,9,4,2,45,52,97,3,30,3.09278350515464,30.9278350515464,53.6082474226804,46.3917525773196
"25","13","1",10,10,7,9,10,6,11,4,10,6,9,6,6,9,4,5,69,56,125,15,15,12,12,44.8,55.2
"26","13","2",13,10,11,5,11,8,4,5,9,6,8,4,4,4,4,1,67,43,110,14,16,12.7272727272727,14.5454545454545,39.0909090909091,60.9090909090909
"27","13","3",8,8,9,3,10,5,6,0,8,4,7,2,2,4,0,0,51,28,79,8,12,10.126582278481,15.1898734177215,35.4430379746835,64.5569620253165
"28","13","4",7,3,13,1,12,15,3,2,4,11,14,4,2,3,2,0,59,40,99,7,29,7.07070707070707,29.2929292929293,40.4040404040404,59.5959595959596
"29","13","5",4,2,2,5,5,8,6,1,2,5,11,2,2,5,1,2,35,31,66,6,19,9.09090909090909,28.7878787878788,46.969696969697,53.030303030303
"30","13","6",9,3,5,3,5,8,4,1,3,4,9,2,2,3,1,0,40,25,65,9,17,13.8461538461538,26.1538461538462,38.4615384615385,61.5384615384615
"31","14","1",0,0,0,1,1,3,2,0,0,2,4,1,1,1,0,0,9,10,19,0,7,0,36.8421052631579,52.6315789473684,47.3684210526316
"32","14","2",20,7,8,1,7,6,2,1,7,2,6,2,2,2,1,1,54,24,78,21,12,26.9230769230769,15.3846153846154,30.7692307692308,69.2307692307692
"33","14","3",5,6,8,0,6,16,3,1,6,2,14,4,1,3,1,0,46,33,79,5,30,6.32911392405063,37.9746835443038,41.7721518987342,58.2278481012658
"34","14","4",2,5,7,4,6,4,6,3,5,7,3,4,6,3,3,1,39,33,72,3,7,4.16666666666667,9.72222222222222,45.8333333333333,54.1666666666667
"35","14","5",0,4,7,4,6,17,4,3,3,7,16,3,5,2,3,1,47,41,88,1,33,1.13636363636364,37.5,46.5909090909091,53.4090909090909
"36","14","6",13,8,10,2,11,11,4,0,8,4,12,2,1,3,0,0,61,31,92,13,23,14.1304347826087,25,33.695652173913,66.304347826087
"37","15","1",10,8,4,9,7,11,4,9,8,5,13,4,7,6,9,3,64,56,120,13,24,10.8333333333333,20,46.6666666666667,53.3333333333333
"38","15","2",11,4,5,4,5,11,5,6,3,5,11,8,3,8,6,8,52,54,106,19,22,17.9245283018868,20.7547169811321,50.9433962264151,49.0566037735849
"39","15","3",6,4,4,7,6,2,7,2,4,7,3,2,5,3,2,3,39,31,70,9,5,12.8571428571429,7.14285714285714,44.2857142857143,55.7142857142857
"40","15","4",9,6,3,3,2,6,3,4,6,0,4,4,5,2,4,9,38,35,73,18,10,24.6575342465753,13.6986301369863,47.9452054794521,52.0547945205479
"41","15","5",0,2,2,5,4,7,4,4,2,4,9,3,2,6,4,1,29,33,62,1,16,1.61290322580645,25.8064516129032,53.2258064516129,46.7741935483871
"42","15","6",3,3,4,0,2,6,3,1,2,1,4,4,1,2,1,0,23,17,40,3,10,7.5,25,42.5,57.5
"43","16","1",16,12,6,11,9,12,6,11,12,5,15,6,7,9,10,10,83,77,160,26,27,16.25,16.875,48.125,51.875
"44","16","2",0,2,3,7,3,11,7,11,2,8,11,11,7,10,10,25,44,87,131,25,22,19.0839694656489,16.793893129771,66.412213740458,33.587786259542
"45","16","3",0,0,0,2,1,9,4,9,0,2,9,12,1,12,9,56,26,103,129,56,18,43.4108527131783,13.953488372093,79.8449612403101,20.1550387596899
"46","16","4",8,4,6,4,6,4,4,8,4,7,3,8,5,7,8,13,46,56,102,21,7,20.5882352941176,6.86274509803922,54.9019607843137,45.0980392156863
"47","16","5",0,2,6,0,5,11,3,3,3,4,10,6,2,4,3,1,33,33,66,1,21,1.51515151515152,31.8181818181818,50,50
"48","16","6",1,2,4,2,2,6,3,4,2,4,4,4,4,2,3,5,24,31,55,6,10,10.9090909090909,18.1818181818182,56.3636363636364,43.6363636363636
"49","17","1",1,3,3,6,5,6,6,14,3,6,8,14,3,17,14,9,45,76,121,10,14,8.26446280991735,11.5702479338843,62.8099173553719,37.1900826446281
"50","17","2",1,6,7,5,6,5,3,9,5,6,4,7,5,7,9,6,43,51,94,7,9,7.4468085106383,9.57446808510638,54.2553191489362,45.7446808510638
"51","17","3",0,1,1,2,1,0,1,7,0,2,0,6,1,6,6,49,13,73,86,49,0,56.9767441860465,0,84.8837209302326,15.1162790697674
"52","17","4",0,1,0,1,1,0,1,7,1,0,1,7,0,8,7,17,11,44,55,17,1,30.9090909090909,1.81818181818182,80,20
"53","17","5",0,0,0,0,0,1,0,3,0,0,1,3,0,3,3,24,4,37,41,24,2,58.5365853658537,4.8780487804878,90.2439024390244,9.75609756097561
"54","17","6",0,0,0,0,0,1,0,4,0,0,1,4,0,4,5,28,6,44,50,28,2,56,4,88,12
"55","18","1",2,4,4,5,6,17,6,6,4,5,19,7,4,9,6,9,52,64,116,11,36,9.48275862068965,31.0344827586207,55.1724137931034,44.8275862068966
"56","18","2",2,2,5,3,3,11,8,5,2,6,10,10,5,9,6,6,41,55,96,8,21,8.33333333333333,21.875,57.2916666666667,42.7083333333333
"57","18","3",41,6,9,2,9,16,3,3,7,5,16,4,3,3,3,3,92,44,136,44,32,32.3529411764706,23.5294117647059,32.3529411764706,67.6470588235294
"58","18","4",90,9,7,4,8,3,4,1,9,2,4,1,3,2,1,1,129,23,152,91,7,59.8684210526316,4.60526315789474,15.1315789473684,84.8684210526316
"59","18","5",91,4,4,0,4,0,0,0,4,0,0,0,0,0,0,0,106,4,110,91,0,82.7272727272727,0,3.63636363636364,96.3636363636364
"60","18","6",0,0,0,0,0,0,0,0,0,0,0,0,0,0,0,0,3,0,3,0,0,0,0,0,100
"61","19","1",2,5,5,5,7,8,7,5,5,5,10,7,3,10,5,6,45,53,98,8,18,8.16326530612245,18.3673469387755,54.0816326530612,45.9183673469388
"62","19","2",16,7,7,3,8,12,5,1,8,3,12,3,3,3,1,0,62,33,95,16,24,16.8421052631579,25.2631578947368,34.7368421052632,65.2631578947368
"63","19","3",65,9,9,1,7,4,4,0,8,1,2,3,3,1,0,0,101,19,120,65,6,54.1666666666667,5,15.8333333333333,84.1666666666667
"64","19","4",30,8,9,2,9,4,1,2,8,3,4,1,2,1,2,0,67,22,89,30,8,33.7078651685393,8.98876404494382,24.7191011235955,75.2808988764045
"65","19","5",42,7,10,0,9,4,1,0,7,3,3,1,1,0,0,0,76,15,91,42,7,46.1538461538462,7.69230769230769,16.4835164835165,83.5164835164835
"66","19","6",12,5,4,2,4,0,2,0,5,1,0,0,2,0,0,0,32,8,40,12,0,30,0,20,80
"67","2","1",10,2,1,1,1,0,1,0,2,0,0,0,1,0,0,0,19,3,22,10,0,45.4545454545455,0,13.6363636363636,86.3636363636364
"68","2","2",8,4,1,5,2,2,4,2,3,2,3,1,3,3,2,2,29,21,50,10,5,20,10,42,58
"69","2","3",2,2,5,1,5,9,2,3,2,4,8,4,1,4,3,2,30,30,60,4,17,6.66666666666667,28.3333333333333,50,50
"70","2","4",1,2,2,2,2,6,7,3,2,2,6,8,2,8,2,1,25,34,59,2,12,3.38983050847458,20.3389830508475,57.6271186440678,42.3728813559322
"71","2","5",58,3,5,2,6,7,4,1,4,4,8,2,2,3,1,1,89,25,114,59,15,51.7543859649123,13.1578947368421,21.9298245614035,78.0701754385965
"72","2","6",72,5,6,0,7,1,0,0,6,1,1,0,0,0,0,0,94,8,102,72,2,70.5882352941177,1.96078431372549,7.84313725490196,92.156862745098
"73","20","1",4,5,6,2,3,5,3,3,5,3,3,4,4,2,3,5,33,30,63,9,8,14.2857142857143,12.6984126984127,47.6190476190476,52.3809523809524
"74","20","2",11,5,3,3,1,5,7,4,5,1,3,8,5,7,4,3,40,38,78,14,8,17.9487179487179,10.2564102564103,48.7179487179487,51.2820512820513
"75","20","3",6,3,7,2,5,11,7,1,2,6,9,7,3,5,1,0,43,35,78,6,20,7.69230769230769,25.6410256410256,44.8717948717949,55.1282051282051
"76","20","4",4,6,5,5,6,7,7,5,7,4,8,6,5,7,5,5,48,47,95,9,15,9.47368421052632,15.7894736842105,49.4736842105263,50.5263157894737
"77","20","5",14,6,8,1,8,12,2,1,6,3,11,2,1,2,1,0,53,28,81,14,23,17.2839506172839,28.3950617283951,34.5679012345679,65.4320987654321
"78","20","6",7,8,12,1,11,9,4,0,8,6,7,3,3,1,0,0,54,29,83,7,16,8.43373493975904,19.2771084337349,34.9397590361446,65.0602409638554
"79","21","1",4,2,1,0,2,0,0,0,2,0,1,0,0,0,0,0,11,4,15,4,1,26.6666666666667,6.66666666666667,26.6666666666667,73.3333333333333
"80","21","2",14,4,2,3,2,3,4,0,3,1,4,1,2,2,0,0,34,14,48,14,7,29.1666666666667,14.5833333333333,29.1666666666667,70.8333333333333
"81","21","3",4,3,2,4,2,0,2,2,3,3,0,0,3,0,2,2,20,15,35,6,0,17.1428571428571,0,42.8571428571429,57.1428571428571
"82","21","4",4,5,6,3,6,1,3,0,5,4,2,0,3,0,0,0,30,15,45,4,3,8.88888888888889,6.66666666666667,33.3333333333333,66.6666666666667
"83","21","5",8,2,2,0,2,0,0,0,2,0,0,0,0,0,0,0,17,2,19,8,0,42.1052631578947,0,10.5263157894737,89.4736842105263
"84","21","6",11,1,1,2,2,0,2,0,2,2,1,0,2,0,0,0,22,7,29,11,1,37.9310344827586,3.44827586206897,24.1379310344828,75.8620689655172
"85","22","1",4,4,6,8,9,6,7,4,4,10,9,3,5,6,4,3,49,46,95,7,15,7.36842105263158,15.7894736842105,48.4210526315789,51.5789473684211
"86","22","2",3,6,8,10,12,19,11,6,6,11,23,7,5,12,6,2,76,74,150,5,42,3.33333333333333,28,49.3333333333333,50.6666666666667
"87","22","3",1,4,6,4,7,16,13,4,4,7,17,13,4,14,5,3,57,68,125,4,33,3.2,26.4,54.4,45.6
"88","22","4",2,1,4,2,4,40,7,2,1,5,41,7,2,7,2,1,64,67,131,3,81,2.29007633587786,61.8320610687023,51.1450381679389,48.8549618320611
"89","22","5",15,7,7,5,7,7,3,4,7,5,8,2,5,2,4,3,57,37,94,18,15,19.1489361702128,15.9574468085106,39.3617021276596,60.6382978723404
"90","22","6",16,7,7,3,10,0,1,2,7,3,2,0,1,2,2,2,48,20,68,18,2,26.4705882352941,2.94117647058824,29.4117647058824,70.5882352941177
"91","23","1",0,1,9,6,9,22,9,4,1,14,21,7,6,6,4,7,61,68,129,7,43,5.42635658914729,33.3333333333333,52.7131782945736,47.2868217054264
"92","23","2",11,3,9,4,11,10,5,5,3,10,12,6,3,8,6,9,60,58,118,20,22,16.9491525423729,18.6440677966102,49.1525423728814,50.8474576271186
"93","23","3",9,7,13,7,13,8,7,4,7,13,7,4,7,4,4,4,69,52,121,13,15,10.7438016528926,12.396694214876,42.9752066115703,57.0247933884297
"94","23","4",6,7,5,7,6,4,7,5,7,5,5,4,6,5,4,2,47,41,88,8,9,9.09090909090909,10.2272727272727,46.5909090909091,53.4090909090909
"95","23","5",5,2,4,3,4,3,3,1,2,5,3,1,3,0,1,0,26,17,43,5,6,11.6279069767442,13.953488372093,39.5348837209302,60.4651162790698
"96","23","6",5,3,3,2,3,2,2,3,3,2,3,3,2,3,3,2,25,22,47,7,5,14.8936170212766,10.6382978723404,46.8085106382979,53.1914893617021
"97","24","1",9,8,10,2,10,7,1,3,7,4,8,2,1,3,3,2,52,31,83,11,15,13.2530120481928,18.0722891566265,37.3493975903614,62.6506024096386
"98","24","2",25,10,16,8,17,9,8,3,11,14,10,3,8,4,3,1,99,54,153,26,19,16.9934640522876,12.4183006535948,35.2941176470588,64.7058823529412
"99","24","3",15,15,12,9,12,7,6,6,14,6,7,3,8,3,6,10,83,59,142,25,14,17.6056338028169,9.85915492957746,41.5492957746479,58.4507042253521
"100","24","4",24,13,15,12,17,8,11,7,13,14,10,6,9,8,6,5,107,74,181,29,18,16.0220994475138,9.94475138121547,40.8839779005525,59.1160220994475
"101","24","5",13,5,8,5,8,23,7,5,5,8,22,7,5,7,5,8,75,69,144,21,45,14.5833333333333,31.25,47.9166666666667,52.0833333333333
"102","24","6",6,6,12,2,13,12,5,2,6,8,12,5,2,5,2,1,60,42,102,7,24,6.86274509803922,23.5294117647059,41.1764705882353,58.8235294117647
"103","25","1",1,3,8,4,10,19,8,2,3,9,21,6,2,8,2,1,56,54,110,2,40,1.81818181818182,36.3636363636364,49.0909090909091,50.9090909090909
"104","25","2",1,2,6,5,5,16,9,1,2,9,15,6,6,4,1,1,46,46,92,2,31,2.17391304347826,33.695652173913,50,50
"105","25","3",0,0,5,2,4,20,5,0,0,6,20,3,2,3,0,0,38,35,73,0,40,0,54.7945205479452,47.9452054794521,52.0547945205479
"106","25","4",0,3,6,1,6,13,2,2,3,4,13,3,1,3,2,0,35,30,65,0,26,0,40,46.1538461538462,53.8461538461538
"107","25","5",4,3,6,1,5,9,2,1,2,4,8,2,1,1,1,0,32,21,53,4,17,7.54716981132075,32.0754716981132,39.622641509434,60.377358490566
"108","25","6",1,1,2,2,4,24,3,0,1,3,27,1,0,3,0,0,39,36,75,1,51,1.33333333333333,68,48,52
"109","26","1",4,5,5,6,8,12,7,7,5,6,15,9,3,11,7,11,55,69,124,15,27,12.0967741935484,21.7741935483871,55.6451612903226,44.3548387096774
"110","26","2",4,7,7,6,8,13,6,6,7,5,14,6,4,7,5,5,57,56,113,9,27,7.9646017699115,23.8938053097345,49.5575221238938,50.4424778761062
"111","26","3",0,0,2,3,1,6,5,8,0,5,6,9,4,9,8,22,27,64,91,22,12,24.1758241758242,13.1868131868132,70.3296703296703,29.6703296703297
"112","26","4",4,1,3,4,2,9,7,3,2,6,8,5,6,4,3,4,36,38,74,8,17,10.8108108108108,22.972972972973,51.3513513513514,48.6486486486486
"113","26","5",4,6,6,3,5,6,5,2,6,3,6,4,4,3,2,1,39,30,69,5,12,7.2463768115942,17.3913043478261,43.4782608695652,56.5217391304348
"114","26","6",2,3,3,5,1,4,7,3,3,5,3,5,7,3,3,4,30,34,64,6,7,9.375,10.9375,53.125,46.875
"115","27","1",9,10,12,3,11,6,3,4,11,4,5,4,4,3,4,3,61,38,99,12,11,12.1212121212121,11.1111111111111,38.3838383838384,61.6161616161616
"116","27","2",11,11,15,4,14,8,4,1,11,8,7,1,5,0,1,0,70,34,104,11,15,10.5769230769231,14.4230769230769,32.6923076923077,67.3076923076923
"117","27","3",4,7,9,4,9,14,5,4,6,7,14,5,4,5,4,3,58,49,107,7,28,6.54205607476636,26.1682242990654,45.7943925233645,54.2056074766355
"118","27","4",10,8,8,4,8,9,2,3,8,4,9,0,5,0,3,2,54,32,86,12,18,13.953488372093,20.9302325581395,37.2093023255814,62.7906976744186
"119","27","5",6,6,9,2,6,12,6,0,6,6,9,4,5,1,0,0,49,32,81,6,21,7.40740740740741,25.9259259259259,39.5061728395062,60.4938271604938
"120","27","6",3,4,6,4,4,12,5,2,3,6,11,3,5,2,2,2,42,35,77,5,23,6.49350649350649,29.8701298701299,45.4545454545455,54.5454545454545
"121","28","1",1,3,5,2,3,10,5,7,3,4,9,9,4,8,7,5,38,50,88,6,19,6.81818181818182,21.5909090909091,56.8181818181818,43.1818181818182
"122","28","2",2,3,7,6,5,8,4,7,4,10,6,5,9,3,7,3,45,47,92,5,14,5.43478260869565,15.2173913043478,51.0869565217391,48.9130434782609
"123","28","3",0,1,2,1,3,5,2,4,1,2,5,5,0,5,3,33,18,57,75,33,10,44,13.3333333333333,76,24
"124","28","4",0,0,0,1,1,0,0,3,0,1,1,2,0,3,3,67,5,80,85,67,1,78.8235294117647,1.17647058823529,94.1176470588235,5.88235294117647
"125","28","5",0,0,1,2,0,5,4,6,0,3,4,8,3,7,6,16,19,49,68,16,9,23.5294117647059,13.2352941176471,72.0588235294118,27.9411764705882
"126","28","6",0,1,3,0,1,21,3,3,1,2,18,6,2,4,3,6,33,44,77,6,39,7.79220779220779,50.6493506493507,57.1428571428571,42.8571428571429
"127","29","1",18,10,12,2,10,22,5,1,10,4,19,4,4,2,1,1,81,47,128,19,41,14.84375,32.03125,36.71875,63.28125
"128","29","2",6,5,8,1,8,18,4,3,6,4,17,6,2,5,3,8,56,51,107,14,35,13.0841121495327,32.7102803738318,47.6635514018692,52.3364485981308
"129","29","3",44,9,8,1,8,5,2,0,10,0,5,1,1,1,0,0,80,18,98,44,10,44.8979591836735,10.2040816326531,18.3673469387755,81.6326530612245
"130","29","4",19,5,7,1,6,3,1,1,4,3,3,1,1,1,1,0,45,15,60,19,6,31.6666666666667,10,25,75
"131","29","5",0,0,2,1,1,1,1,0,0,2,1,0,1,0,0,0,8,5,13,0,2,0,15.3846153846154,38.4615384615385,61.5384615384615
"132","29","6",3,1,2,1,2,1,2,1,2,2,1,1,2,1,1,1,16,11,27,4,2,14.8148148148148,7.40740740740741,40.7407407407407,59.2592592592593
"133","3","1",7,5,7,3,8,5,4,1,6,4,6,2,2,3,1,1,43,25,68,8,11,11.7647058823529,16.1764705882353,36.7647058823529,63.2352941176471
"134","3","2",1,1,2,1,2,12,1,1,1,2,11,1,1,1,1,1,22,21,43,2,23,4.65116279069767,53.4883720930233,48.8372093023256,51.1627906976744
"135","3","3",9,5,4,4,4,4,5,1,5,3,4,2,4,2,1,0,38,22,60,9,8,15,13.3333333333333,36.6666666666667,63.3333333333333
"136","3","4",0,3,4,2,5,6,2,0,2,4,7,0,1,1,0,0,24,16,40,0,13,0,32.5,40,60
"137","3","5",3,1,1,0,0,6,0,1,0,1,5,1,1,0,1,1,14,11,25,4,11,16,44,44,56
"138","3","6",1,1,1,2,1,7,2,1,2,2,7,1,3,0,1,0,19,16,35,1,14,2.85714285714286,40,45.7142857142857,54.2857142857143
"139","30","1",2,6,6,4,5,8,6,8,6,4,7,10,5,9,8,5,47,55,102,7,15,6.86274509803922,14.7058823529412,53.921568627451,46.078431372549
"140","30","2",5,5,4,3,3,16,4,4,5,2,16,5,3,5,4,1,46,42,88,6,32,6.81818181818182,36.3636363636364,47.7272727272727,52.2727272727273
"141","30","3",1,4,11,6,11,4,3,7,4,13,4,4,7,4,8,11,49,56,105,12,8,11.4285714285714,7.61904761904762,53.3333333333333,46.6666666666667
"142","30","4",5,3,6,3,3,4,4,5,3,6,2,6,6,3,5,9,35,41,76,14,6,18.4210526315789,7.89473684210526,53.9473684210526,46.0526315789474
"143","30","5",4,6,10,0,9,9,1,0,5,4,8,1,1,0,0,0,41,20,61,4,17,6.55737704918033,27.8688524590164,32.7868852459016,67.2131147540984
"144","30","6",17,5,4,4,6,5,4,3,5,3,7,3,2,5,2,6,48,36,84,23,12,27.3809523809524,14.2857142857143,42.8571428571429,57.1428571428571
"145","31","1",14,8,11,3,7,17,5,3,8,6,13,5,7,1,3,5,70,49,119,19,30,15.9663865546218,25.2100840336134,41.1764705882353,58.8235294117647
"146","31","2",4,4,4,4,4,6,7,4,4,4,6,7,4,7,4,2,39,39,78,6,12,7.69230769230769,15.3846153846154,50,50
"147","31","3",10,3,4,1,2,3,2,3,2,2,1,4,2,3,3,3,29,22,51,13,4,25.4901960784314,7.84313725490196,43.1372549019608,56.8627450980392
"148","31","4",6,2,2,0,1,0,0,0,2,0,0,0,0,0,0,0,13,3,16,6,0,37.5,0,18.75,81.25
"149","31","5",12,2,2,0,1,1,0,0,1,0,1,0,0,0,0,0,20,3,23,12,2,52.1739130434783,8.69565217391304,13.0434782608696,86.9565217391304
"150","31","6",7,2,1,1,1,0,0,1,2,0,0,0,1,0,1,0,16,4,20,7,0,35,0,20,80
"151","32","1",7,5,7,6,6,8,4,11,5,8,7,9,7,8,11,9,54,67,121,16,15,13.2231404958678,12.396694214876,55.3719008264463,44.6280991735537
"152","32","2",8,9,19,4,18,20,9,1,9,15,19,5,6,4,1,0,90,60,150,8,39,5.33333333333333,26,40,60
"153","32","3",1,2,8,4,7,32,11,1,2,10,31,7,5,7,1,1,67,66,133,2,63,1.50375939849624,47.3684210526316,49.6240601503759,50.3759398496241
"154","32","4",1,1,7,0,5,29,7,0,1,7,26,7,3,4,0,0,52,49,101,1,55,0.99009900990099,54.4554455445545,48.5148514851485,51.4851485148515
"155","32","5",6,1,6,3,5,24,5,3,1,8,22,5,4,4,3,2,54,51,105,8,46,7.61904761904762,43.8095238095238,48.5714285714286,51.4285714285714
"156","32","6",0,4,6,3,6,4,5,3,5,5,4,5,3,5,3,0,34,30,64,0,8,0,12.5,46.875,53.125
"157","33","1",0,1,2,2,3,2,3,1,1,3,3,2,1,3,1,1,16,16,32,1,5,3.125,15.625,50,50
"158","33","2",5,4,10,3,4,29,11,0,4,10,22,8,10,1,0,0,68,56,124,5,51,4.03225806451613,41.1290322580645,45.1612903225806,54.8387096774194
"159","33","3",0,0,0,0,0,4,0,0,0,0,3,0,0,0,0,0,5,5,10,0,7,0,70,50,50
"160","33","4",0,0,0,0,0,4,0,0,0,0,3,0,0,0,0,0,5,5,10,0,7,0,70,50,50
"161","33","5",1,1,0,0,1,1,0,0,1,0,1,0,0,0,0,0,6,3,9,1,2,11.1111111111111,22.2222222222222,33.3333333333333,66.6666666666667
"162","33","6",0,0,0,0,0,2,1,0,0,0,1,1,0,0,0,0,4,4,8,0,3,0,37.5,50,50
"163","34","1",7,9,8,8,8,4,7,7,9,7,4,6,8,5,6,1,58,49,107,8,8,7.47663551401869,7.47663551401869,45.7943925233645,54.2056074766355
"164","34","2",14,10,13,5,13,4,5,2,10,8,3,3,5,2,2,2,67,37,104,16,7,15.3846153846154,6.73076923076923,35.5769230769231,64.4230769230769
"165","34","3",8,4,4,6,6,10,9,0,4,7,12,3,4,5,0,0,49,36,85,8,22,9.41176470588235,25.8823529411765,42.3529411764706,57.6470588235294
"166","34","4",0,0,2,1,3,14,6,0,0,3,14,5,1,5,0,0,28,29,57,0,28,0,49.1228070175439,50.8771929824561,49.1228070175439
"167","34","5",0,1,2,5,6,2,3,3,1,5,6,1,1,5,3,1,24,24,48,1,8,2.08333333333333,16.6666666666667,50,50
"168","34","6",0,1,1,2,3,5,3,2,1,2,7,3,1,4,2,1,19,22,41,1,12,2.4390243902439,29.2682926829268,53.6585365853659,46.3414634146341
"169","35","1",17,7,7,2,7,6,5,0,8,2,6,3,2,3,0,0,54,24,78,17,12,21.7948717948718,15.3846153846154,30.7692307692308,69.2307692307692
"170","35","2",16,7,7,2,8,13,2,0,7,2,13,0,1,1,0,0,56,26,82,16,26,19.5121951219512,31.7073170731707,31.7073170731707,68.2926829268293
"171","35","3",1,1,1,0,1,10,0,0,1,0,10,0,0,0,0,0,16,12,28,1,20,3.57142857142857,71.4285714285714,42.8571428571429,57.1428571428571
"172","35","4",1,1,1,0,0,7,0,0,1,0,7,0,0,0,0,0,12,9,21,1,14,4.76190476190476,66.6666666666667,42.8571428571429,57.1428571428571
"173","35","5",1,1,0,0,1,3,0,0,1,0,4,0,0,0,0,0,8,6,14,1,7,7.14285714285714,50,42.8571428571429,57.1428571428571
"174","35","6",0,0,0,0,0,1,0,0,0,0,0,0,0,0,0,0,2,2,4,0,1,0,25,50,50
"175","36","1",5,3,1,3,0,5,4,5,3,2,4,6,4,5,5,11,28,41,69,16,9,23.1884057971014,13.0434782608696,59.4202898550725,40.5797101449275
"176","36","2",2,3,4,2,6,6,5,0,3,3,8,2,1,4,0,0,30,22,52,2,14,3.84615384615385,26.9230769230769,42.3076923076923,57.6923076923077
"177","36","3",1,9,11,1,11,7,1,0,9,3,7,0,1,0,0,0,43,21,64,1,14,1.5625,21.875,32.8125,67.1875
"178","36","4",0,1,7,0,7,13,2,0,1,6,13,2,0,2,0,0,32,25,57,0,26,0,45.6140350877193,43.859649122807,56.140350877193
"179","36","5",0,0,5,0,4,14,3,0,0,5,12,3,1,2,0,0,27,25,52,0,26,0,50,48.0769230769231,51.9230769230769
"180","36","6",0,1,5,2,3,15,7,1,1,6,13,6,4,4,1,2,35,39,74,2,28,2.7027027027027,37.8378378378378,52.7027027027027,47.2972972972973
"181","37","1",5,4,5,5,8,14,8,6,4,6,16,10,2,12,6,2,56,60,116,7,30,6.03448275862069,25.8620689655172,51.7241379310345,48.2758620689655
"182","37","2",12,4,6,8,8,5,7,5,5,9,7,4,6,6,5,5,58,47,105,17,12,16.1904761904762,11.4285714285714,44.7619047619048,55.2380952380952
"183","37","3",154,2,2,0,2,0,0,0,2,0,0,0,0,0,0,0,163,2,165,154,0,93.3333333333333,0,1.21212121212121,98.7878787878788
"184","37","4",69,5,4,1,4,1,1,0,5,0,1,0,1,0,0,0,88,7,95,69,2,72.6315789473684,2.10526315789474,7.36842105263158,92.6315789473684
"185","37","5",55,4,4,0,4,0,0,0,4,0,0,0,0,0,0,0,70,4,74,55,0,74.3243243243243,0,5.40540540540541,94.5945945945946
"186","37","6",25,3,3,1,3,2,1,0,4,0,2,0,1,0,0,0,41,7,48,25,4,52.0833333333333,8.33333333333333,14.5833333333333,85.4166666666667
"187","38","1",1,3,6,6,5,23,8,12,3,10,22,14,8,13,13,5,66,89,155,6,45,3.87096774193548,29.0322580645161,57.4193548387097,42.5806451612903
"188","38","2",0,2,7,4,8,27,7,7,2,9,29,9,3,11,7,2,64,73,137,2,56,1.45985401459854,40.8759124087591,53.2846715328467,46.7153284671533
"189","38","3",0,0,4,1,0,17,5,0,0,5,13,4,4,0,0,0,28,28,56,0,30,0,53.5714285714286,50,50
"190","38","4",0,1,3,4,5,6,5,0,1,6,7,1,2,3,0,0,25,22,47,0,13,0,27.6595744680851,46.8085106382979,53.1914893617021
"191","38","5",0,3,8,6,3,16,8,8,3,11,12,9,11,5,8,5,54,65,119,5,28,4.20168067226891,23.5294117647059,54.6218487394958,45.3781512605042
"192","38","6",2,3,9,2,7,37,6,2,3,8,34,6,4,4,2,2,69,65,134,4,71,2.98507462686567,52.9850746268657,48.5074626865672,51.4925373134328
"193","39","1",8,5,5,5,5,19,5,5,5,5,20,5,5,6,5,6,59,58,117,14,39,11.965811965812,33.3333333333333,49.5726495726496,50.4273504273504
"194","39","2",5,2,2,3,4,15,3,3,2,3,17,3,1,4,3,0,38,35,73,5,32,6.84931506849315,43.8356164383562,47.9452054794521,52.0547945205479
"195","39","3",0,0,1,3,1,2,3,3,0,4,2,3,3,3,3,10,14,30,44,10,4,22.7272727272727,9.09090909090909,68.1818181818182,31.8181818181818
"196","39","4",0,0,2,0,1,16,4,1,0,2,14,6,1,4,1,0,25,30,55,0,30,0,54.5454545454545,54.5454545454545,45.4545454545455
"197","39","5",0,0,0,0,0,5,0,3,0,0,6,3,0,3,3,12,10,28,38,12,11,31.5789473684211,28.9473684210526,73.6842105263158,26.3157894736842
"198","39","6",0,0,0,0,0,7,1,3,0,0,8,4,0,4,3,5,13,25,38,5,15,13.1578947368421,39.4736842105263,65.7894736842105,34.2105263157895
"199","4","1",5,9,10,8,9,10,11,7,9,9,9,10,9,10,7,3,70,68,138,8,19,5.79710144927536,13.768115942029,49.2753623188406,50.7246376811594
"200","4","2",0,2,1,3,2,21,9,13,2,2,22,19,2,21,13,5,52,88,140,5,43,3.57142857142857,30.7142857142857,62.8571428571429,37.1428571428571
"201","4","3",0,0,0,1,0,14,10,14,0,1,14,23,1,24,15,12,40,92,132,12,28,9.09090909090909,21.2121212121212,69.6969696969697,30.3030303030303
"202","4","4",0,4,6,3,7,32,5,4,4,5,33,5,2,7,4,5,62,67,129,5,65,3.87596899224806,50.3875968992248,51.937984496124,48.062015503876
"203","4","5",0,0,1,1,1,15,8,7,0,2,14,14,1,14,7,19,34,73,107,19,29,17.7570093457944,27.1028037383178,68.2242990654206,31.7757009345794
"204","4","6",0,3,5,3,5,19,9,9,3,5,20,15,3,16,9,3,55,75,130,3,39,2.30769230769231,30,57.6923076923077,42.3076923076923
"205","40","1",17,6,9,5,8,6,8,2,6,8,5,5,6,4,2,4,62,42,104,21,11,20.1923076923077,10.5769230769231,40.3846153846154,59.6153846153846
"206","40","2",1,1,6,2,8,29,4,0,1,7,30,2,0,4,0,0,52,46,98,1,59,1.02040816326531,60.2040816326531,46.9387755102041,53.0612244897959
"207","40","3",17,9,12,7,10,18,12,1,9,10,16,6,9,3,1,0,87,56,143,17,34,11.8881118881119,23.7762237762238,39.1608391608392,60.8391608391608
"208","40","4",8,6,8,8,11,23,11,0,6,10,27,3,5,7,1,0,77,60,137,8,50,5.83941605839416,36.4963503649635,43.7956204379562,56.2043795620438
"209","40","5",1,2,8,1,7,25,4,1,2,7,25,4,2,3,1,0,51,45,96,1,50,1.04166666666667,52.0833333333333,46.875,53.125
"210","40","6",1,3,7,3,4,25,8,2,3,7,23,6,6,4,2,2,55,54,109,3,48,2.75229357798165,44.0366972477064,49.5412844036697,50.4587155963303
"211","41","1",2,3,7,5,6,5,6,5,3,9,4,6,6,5,5,6,40,46,86,8,9,9.30232558139535,10.4651162790698,53.4883720930233,46.5116279069767
"212","41","2",0,0,2,0,2,26,2,2,0,2,26,4,0,4,2,0,36,39,75,0,52,0,69.3333333333333,52,48
"213","41","3",3,1,3,0,4,16,5,0,2,2,17,5,0,5,0,0,35,31,66,3,33,4.54545454545455,50,46.969696969697,53.030303030303
"214","41","4",1,5,5,5,4,6,7,3,5,5,5,5,5,4,2,2,36,36,72,3,11,4.16666666666667,15.2777777777778,50,50
"215","41","5",2,3,2,5,2,0,5,3,3,3,0,3,4,3,2,2,22,23,45,4,0,8.88888888888889,0,51.1111111111111,48.8888888888889
"216","41","6",0,1,0,1,1,0,0,1,1,1,1,0,1,0,1,13,6,19,25,13,1,52,4,76,24
"217","42","1",8,6,5,3,5,5,6,3,6,2,6,6,3,7,3,0,43,34,77,8,11,10.3896103896104,14.2857142857143,44.1558441558442,55.8441558441558
"218","42","2",4,4,3,7,4,2,6,7,4,6,3,5,7,6,7,6,39,45,84,10,5,11.9047619047619,5.95238095238095,53.5714285714286,46.4285714285714
"219","42","3",2,2,2,4,2,4,2,6,2,4,4,4,4,4,6,18,24,49,73,20,8,27.3972602739726,10.958904109589,67.1232876712329,32.8767123287671
"220","42","4",0,1,0,2,1,0,1,3,1,1,1,2,0,3,2,19,8,32,40,19,1,47.5,2.5,80,20
"221","42","5",0,0,1,0,1,2,1,2,0,1,2,3,0,3,2,5,7,19,26,5,4,19.2307692307692,15.3846153846154,73.0769230769231,26.9230769230769
"222","42","6",0,0,1,0,0,4,1,3,0,1,3,4,1,2,2,1,9,17,26,1,7,3.84615384615385,26.9230769230769,65.3846153846154,34.6153846153846
"223","43","1",15,8,13,3,12,29,4,3,8,8,29,4,4,3,3,0,89,60,149,15,58,10.0671140939597,38.9261744966443,40.2684563758389,59.7315436241611
"224","43","2",5,9,16,6,13,14,9,4,9,13,11,7,9,4,4,1,77,60,137,6,25,4.37956204379562,18.2481751824818,43.7956204379562,56.2043795620438
"225","43","3",12,8,18,5,20,15,4,2,8,15,16,1,3,2,2,0,85,49,134,12,31,8.95522388059701,23.134328358209,36.5671641791045,63.4328358208955
"226","43","4",41,12,14,3,15,3,4,1,12,6,4,2,2,3,1,1,95,32,127,42,7,33.0708661417323,5.51181102362205,25.1968503937008,74.8031496062992
"227","43","5",15,5,7,5,3,8,9,4,5,7,5,8,8,5,4,3,58,46,104,18,13,17.3076923076923,12.5,44.2307692307692,55.7692307692308
"228","43","6",13,9,14,3,12,13,5,2,8,8,12,4,4,3,2,0,73,42,115,13,25,11.304347826087,21.7391304347826,36.5217391304348,63.4782608695652
"229","44","1",1,3,3,5,3,4,7,4,4,4,4,6,5,6,4,4,33,37,70,5,8,7.14285714285714,11.4285714285714,52.8571428571429,47.1428571428571
"230","44","2",7,7,3,5,1,8,8,8,6,1,7,11,6,10,8,13,49,63,112,20,15,17.8571428571429,13.3928571428571,56.25,43.75
"231","44","3",1,2,2,2,4,14,4,4,2,2,17,6,0,9,5,13,35,55,90,14,31,15.5555555555556,34.4444444444444,61.1111111111111,38.8888888888889
"232","44","4",1,2,3,4,3,2,3,7,2,5,2,6,4,5,7,8,26,41,67,9,4,13.4328358208955,5.97014925373134,61.1940298507463,38.8059701492537
"233","44","5",0,0,1,1,0,4,1,7,0,2,3,7,2,6,7,19,14,49,63,19,7,30.1587301587302,11.1111111111111,77.7777777777778,22.2222222222222
"234","44","6",4,0,2,0,3,1,0,3,1,2,2,3,0,4,4,21,16,37,53,25,3,47.1698113207547,5.66037735849057,69.811320754717,30.188679245283
"235","45","1",0,0,1,0,0,15,1,9,0,0,14,11,0,10,9,22,27,68,95,22,29,23.1578947368421,30.5263157894737,71.5789473684211,28.4210526315789
"236","45","2",0,0,0,0,0,0,0,3,0,0,0,3,0,3,3,73,3,85,88,73,0,82.9545454545455,0,96.5909090909091,3.40909090909091
"237","45","3",0,0,0,0,0,3,0,3,0,0,4,3,0,4,4,11,8,27,35,11,7,31.4285714285714,20,77.1428571428571,22.8571428571429
"238","45","4",0,0,0,1,1,3,0,4,0,1,4,3,0,3,3,13,9,30,39,13,7,33.3333333333333,17.9487179487179,76.9230769230769,23.0769230769231
"239","45","5",0,0,0,0,0,4,0,2,0,0,4,2,0,2,2,32,6,45,51,32,8,62.7450980392157,15.6862745098039,88.2352941176471,11.7647058823529
"240","45","6",0,0,0,0,0,0,0,3,0,0,0,2,0,2,2,40,3,49,52,40,0,76.9230769230769,0,94.2307692307692,5.76923076923077
"241","46","1",2,2,3,6,2,11,10,11,2,7,9,15,7,13,11,9,48,75,123,11,20,8.94308943089431,16.260162601626,60.9756097560976,39.0243902439024
"242","46","2",0,0,7,2,5,20,5,1,0,8,18,4,3,3,1,0,41,39,80,0,38,0,47.5,48.75,51.25
"243","46","3",0,0,7,1,5,14,4,0,0,8,12,3,3,1,0,0,33,28,61,0,26,0,42.6229508196721,45.9016393442623,54.0983606557377
"244","46","4",1,1,5,1,3,11,3,0,1,5,8,2,3,0,0,0,26,21,47,1,19,2.12765957446809,40.4255319148936,44.6808510638298,55.3191489361702
"245","46","5",0,1,8,2,8,5,2,0,1,9,4,0,2,0,0,0,27,18,45,0,9,0,20,40,60
"246","46","6",0,0,1,0,1,20,1,0,0,1,20,1,0,1,0,0,25,24,49,0,40,0,81.6326530612245,48.9795918367347,51.0204081632653
"247","47","1",6,4,10,2,11,12,2,0,4,8,12,0,2,0,0,0,49,27,76,6,24,7.89473684210526,31.5789473684211,35.5263157894737,64.4736842105263
"248","47","2",0,0,3,0,1,7,6,2,0,3,5,8,2,6,2,0,21,27,48,0,12,0,25,56.25,43.75
"249","47","3",0,0,4,2,3,6,4,1,0,6,5,3,3,1,1,0,21,21,42,0,11,0,26.1904761904762,50,50
"250","47","4",0,0,2,5,2,4,6,1,0,7,5,1,5,2,1,0,22,22,44,0,9,0,20.4545454545455,50,50
"251","47","5",0,0,2,0,2,10,2,0,0,2,9,2,0,2,0,0,17,17,34,0,19,0,55.8823529411765,50,50
"252","47","6",0,0,2,0,0,7,4,1,0,2,5,5,2,3,1,0,16,19,35,0,12,0,34.2857142857143,54.2857142857143,45.7142857142857
"253","48","1",4,6,5,5,5,2,3,4,6,5,2,2,6,2,5,9,36,38,74,13,4,17.5675675675676,5.40540540540541,51.3513513513514,48.6486486486486
"254","48","2",10,8,10,8,6,5,8,5,8,9,1,5,11,1,4,3,60,45,105,13,6,12.3809523809524,5.71428571428571,42.8571428571429,57.1428571428571
"255","48","3",2,1,1,2,0,2,2,7,1,2,1,7,2,6,7,26,18,54,72,28,3,38.8888888888889,4.16666666666667,75,25
"256","48","4",2,2,2,1,1,4,0,5,2,1,3,4,1,3,4,26,17,47,64,28,7,43.75,10.9375,73.4375,26.5625
"257","48","5",0,0,0,0,0,0,1,2,0,0,0,3,0,3,2,25,3,36,39,25,0,64.1025641025641,0,92.3076923076923,7.69230769230769
"258","48","6",0,0,0,0,0,0,2,2,0,0,0,4,0,4,2,25,4,38,42,25,0,59.5238095238095,0,90.4761904761905,9.52380952380952
"259","49","1",4,3,3,9,7,10,8,8,3,9,14,8,5,12,9,10,53,72,125,14,24,11.2,19.2,57.6,42.4
"260","49","2",1,5,6,3,6,3,6,5,5,4,3,8,3,9,6,2,36,42,78,3,6,3.84615384615385,7.69230769230769,53.8461538461538,46.1538461538462
"261","49","3",0,2,0,4,0,2,2,4,2,2,2,2,4,2,4,14,14,35,49,14,4,28.5714285714286,8.16326530612245,71.4285714285714,28.5714285714286
"262","49","4",0,0,0,1,0,2,1,4,0,1,2,4,1,4,5,8,9,27,36,8,4,22.2222222222222,11.1111111111111,75,25
"263","49","5",0,0,0,2,1,2,1,3,0,2,3,1,1,2,3,17,10,31,41,17,5,41.4634146341463,12.1951219512195,75.609756097561,24.390243902439
"264","49","6",0,0,0,0,0,3,1,3,0,0,3,4,0,3,2,8,7,23,30,8,6,26.6666666666667,20,76.6666666666667,23.3333333333333
"265","5","1",7,1,1,2,0,4,4,9,2,2,3,10,4,9,9,9,31,48,79,16,7,20.253164556962,8.86075949367089,60.7594936708861,39.2405063291139
"266","5","2",0,1,2,2,2,11,5,5,1,3,12,8,2,8,5,11,30,51,81,11,23,13.5802469135802,28.3950617283951,62.962962962963,37.037037037037
"267","5","3",1,1,1,3,3,2,4,2,1,3,5,3,1,6,3,5,19,28,47,6,7,12.7659574468085,14.8936170212766,59.5744680851064,40.4255319148936
"268","5","4",2,1,1,3,2,6,4,1,1,2,7,3,1,4,1,0,21,21,42,2,13,4.76190476190476,30.952380952381,50,50
"269","5","5",0,0,1,2,1,4,2,4,0,3,4,4,2,4,4,5,15,28,43,5,8,11.6279069767442,18.6046511627907,65.1162790697674,34.8837209302326
"270","5","6",0,0,0,2,0,1,1,1,0,2,1,0,1,1,1,1,6,9,15,1,2,6.66666666666667,13.3333333333333,60,40
"271","50","1",2,5,12,7,13,19,10,4,5,14,19,7,6,8,4,7,73,72,145,9,38,6.20689655172414,26.2068965517241,49.6551724137931,50.3448275862069
"272","50","2",5,3,9,7,7,13,12,5,3,13,12,10,9,8,5,1,63,62,125,6,25,4.8,20,49.6,50.4
"273","50","3",0,3,4,4,6,9,9,2,3,5,11,8,2,9,2,1,38,43,81,1,20,1.23456790123457,24.6913580246914,53.0864197530864,46.9135802469136
"274","50","4",2,3,4,2,3,11,4,5,3,3,10,7,3,7,6,4,35,45,80,6,21,7.5,26.25,56.25,43.75
"275","50","5",1,1,2,2,3,11,7,2,1,3,13,7,1,8,2,3,31,39,70,4,24,5.71428571428571,34.2857142857143,55.7142857142857,44.2857142857143
"276","50","6",0,2,3,4,5,5,8,1,2,5,7,5,1,8,1,0,29,31,60,0,12,0,20,51.6666666666667,48.3333333333333
"277","51","1",7,5,6,3,8,3,8,1,5,4,5,6,2,8,2,9,43,42,85,16,8,18.8235294117647,9.41176470588235,49.4117647058824,50.5882352941176
"278","51","2",1,2,5,4,6,11,3,4,2,6,12,3,2,4,3,1,36,36,72,2,23,2.77777777777778,31.9444444444444,50,50
"279","51","3",8,3,2,3,1,2,2,3,3,2,1,2,4,1,3,5,25,23,48,13,3,27.0833333333333,6.25,47.9166666666667,52.0833333333333
"280","51","4",2,1,1,3,0,1,2,3,0,3,0,2,3,1,2,7,13,21,34,9,1,26.4705882352941,2.94117647058824,61.7647058823529,38.2352941176471
"281","51","5",0,0,2,4,2,0,2,2,0,5,0,0,3,1,2,0,13,13,26,0,0,0,0,50,50
"282","51","6",0,0,0,0,0,7,1,1,0,0,7,2,1,2,1,4,11,18,29,4,14,13.7931034482759,48.2758620689655,62.0689655172414,37.9310344827586
"283","52","1",13,8,8,8,8,7,12,2,8,7,8,6,7,7,2,8,68,54,122,21,15,17.2131147540984,12.2950819672131,44.2622950819672,55.7377049180328
"284","52","2",0,3,7,5,9,16,6,5,3,9,17,6,4,7,5,2,53,54,107,2,33,1.86915887850467,30.8411214953271,50.4672897196262,49.5327102803738
"285","52","3",11,8,9,2,11,17,3,0,9,3,19,1,1,2,0,0,64,35,99,11,36,11.1111111111111,36.3636363636364,35.3535353535354,64.6464646464647
"286","52","4",20,5,5,1,4,12,4,0,5,1,11,3,2,2,0,0,52,26,78,20,23,25.6410256410256,29.4871794871795,33.3333333333333,66.6666666666667
"287","52","5",8,6,7,1,6,5,1,1,6,2,5,1,2,0,1,0,37,18,55,8,10,14.5454545454545,18.1818181818182,32.7272727272727,67.2727272727273
"288","52","6",23,2,3,0,3,1,1,0,3,1,1,1,1,0,0,0,36,7,43,23,2,53.4883720930233,4.65116279069767,16.2790697674419,83.7209302325581
"289","53","1",12,7,4,9,4,3,6,7,8,6,3,4,10,3,7,13,55,54,109,25,6,22.9357798165138,5.5045871559633,49.5412844036697,50.4587155963303
"290","53","2",0,2,2,3,1,7,3,4,2,3,7,3,4,3,4,1,24,28,52,1,14,1.92307692307692,26.9230769230769,53.8461538461538,46.1538461538462
"291","53","3",7,5,6,4,6,3,5,1,5,4,3,2,3,3,1,2,38,25,63,9,6,14.2857142857143,9.52380952380952,39.6825396825397,60.3174603174603
"292","53","4",0,0,1,4,0,1,4,1,0,5,1,1,5,1,2,2,13,18,31,2,2,6.45161290322581,6.45161290322581,58.0645161290323,41.9354838709677
"293","53","5",0,0,0,2,1,1,1,2,0,2,2,1,2,2,2,3,9,15,24,3,3,12.5,12.5,62.5,37.5
"294","53","6",0,0,1,0,0,1,0,1,0,1,0,1,0,0,0,0,3,5,8,0,1,0,12.5,62.5,37.5
"295","54","1",8,6,5,7,6,3,7,6,6,6,3,6,7,6,6,9,50,50,100,17,6,17,6,50,50
"296","54","2",0,0,3,0,2,16,2,0,0,3,15,2,1,1,0,0,24,24,48,0,31,0,64.5833333333333,50,50
"297","54","3",0,1,2,0,0,8,5,0,1,1,6,5,1,4,0,0,17,20,37,0,14,0,37.8378378378378,54.0540540540541,45.9459459459459
"298","54","4",0,0,3,0,1,16,4,0,0,3,14,4,2,2,0,0,26,26,52,0,30,0,57.6923076923077,50,50
"299","54","5",0,0,3,3,3,20,4,3,0,6,20,4,3,4,3,5,37,47,84,5,40,5.95238095238095,47.6190476190476,55.9523809523809,44.0476190476191
"300","54","6",0,1,5,3,4,26,6,6,1,7,26,9,3,9,6,10,53,72,125,10,52,8,41.6,57.6,42.4
"301","55","1",3,5,2,6,3,2,8,3,5,4,2,5,6,5,3,1,34,32,66,4,4,6.06060606060606,6.06060606060606,48.4848484848485,51.5151515151515
"302","55","2",0,2,0,3,1,2,2,7,1,1,3,7,1,8,7,6,18,36,54,6,5,11.1111111111111,9.25925925925926,66.6666666666667,33.3333333333333
"303","55","3",0,1,1,1,1,1,0,3,1,2,1,2,2,1,3,14,10,27,37,14,2,37.8378378378378,5.40540540540541,72.972972972973,27.027027027027
"304","55","4",4,2,1,1,2,3,0,3,2,0,3,2,1,2,3,5,18,19,37,9,6,24.3243243243243,16.2162162162162,51.3513513513514,48.6486486486486
"305","55","5",0,3,0,4,1,0,2,3,3,1,1,1,3,2,2,4,13,20,33,4,1,12.1212121212121,3.03030303030303,60.6060606060606,39.3939393939394
"306","55","6",0,1,1,1,0,2,1,1,1,0,2,1,1,1,1,6,9,14,23,6,4,26.0869565217391,17.3913043478261,60.8695652173913,39.1304347826087
"307","56","1",11,3,3,3,4,8,2,2,3,3,9,1,2,3,3,2,37,28,65,13,17,20,26.1538461538462,43.0769230769231,56.9230769230769
"308","56","2",6,8,9,5,8,13,5,4,8,6,11,5,6,3,4,3,59,48,107,9,24,8.41121495327103,22.4299065420561,44.8598130841121,55.1401869158879
"309","56","3",0,2,2,3,4,5,3,4,2,3,7,4,1,6,4,7,25,35,60,7,12,11.6666666666667,20,58.3333333333333,41.6666666666667
"310","56","4",0,0,0,1,1,14,1,0,0,1,16,0,0,1,0,0,19,19,38,0,30,0,78.9473684210526,50,50
"311","56","5",1,1,1,0,1,7,0,3,1,0,7,3,0,3,3,2,15,21,36,3,14,8.33333333333333,38.8888888888889,58.3333333333333,41.6666666666667
"312","56","6",0,0,0,0,0,7,0,0,0,0,7,0,0,0,0,0,8,9,17,0,14,0,82.3529411764706,52.9411764705882,47.0588235294118
"313","57","1",1,2,3,1,4,5,1,2,2,2,6,2,1,3,2,1,21,20,41,2,11,4.8780487804878,26.8292682926829,48.780487804878,51.219512195122
"314","57","2",0,2,9,2,7,16,2,2,2,9,15,2,3,1,2,1,42,36,78,1,31,1.28205128205128,39.7435897435897,46.1538461538462,53.8461538461538
"315","57","3",0,1,6,2,5,12,5,1,1,7,10,4,3,2,1,0,33,30,63,0,22,0,34.9206349206349,47.6190476190476,52.3809523809524
"316","57","4",0,0,5,2,3,14,5,2,0,7,11,5,4,3,2,0,32,34,66,0,25,0,37.8787878787879,51.5151515151515,48.4848484848485
"317","57","5",0,0,0,3,3,3,2,3,0,4,6,2,1,4,3,7,16,28,44,7,9,15.9090909090909,20.4545454545455,63.6363636363636,36.3636363636364
"318","57","6",0,0,0,1,0,0,1,3,0,2,0,2,2,2,3,16,7,28,35,16,0,45.7142857142857,0,80,20
"319","58","1",2,2,5,3,5,8,4,1,2,6,9,2,3,2,1,0,32,26,58,2,17,3.44827586206897,29.3103448275862,44.8275862068966,55.1724137931034
"320","58","2",18,6,8,3,7,10,5,3,6,4,9,5,3,4,3,1,61,37,98,19,19,19.3877551020408,19.3877551020408,37.7551020408163,62.2448979591837
"321","58","3",13,6,10,5,9,11,5,1,6,9,10,1,5,1,1,1,61,36,97,14,21,14.4329896907216,21.6494845360825,37.1134020618557,62.8865979381443
"322","58","4",8,4,5,2,5,12,7,3,4,2,12,8,1,9,3,0,47,41,88,8,24,9.09090909090909,27.2727272727273,46.5909090909091,53.4090909090909
"323","58","5",2,2,5,0,2,13,2,0,2,2,11,2,2,0,0,0,28,20,48,2,24,4.16666666666667,50,41.6666666666667,58.3333333333333
"324","58","6",4,2,3,1,4,12,1,0,2,2,14,0,0,1,0,0,29,20,49,4,26,8.16326530612245,53.0612244897959,40.8163265306122,59.1836734693878
"325","59","1",1,3,4,4,5,10,8,7,3,5,11,10,3,11,7,4,43,56,99,5,21,5.05050505050505,21.2121212121212,56.5656565656566,43.4343434343434
"326","59","2",0,4,5,3,6,12,6,1,4,5,13,3,3,4,1,2,39,36,75,2,25,2.66666666666667,33.3333333333333,48,52
"327","59","3",4,1,6,2,6,16,3,0,1,7,15,1,2,1,0,0,39,29,68,4,31,5.88235294117647,45.5882352941176,42.6470588235294,57.3529411764706
"328","59","4",7,5,3,3,5,15,4,1,5,2,16,2,2,3,1,1,45,33,78,8,31,10.2564102564103,39.7435897435897,42.3076923076923,57.6923076923077
"329","59","5",1,1,2,1,3,3,0,1,1,2,4,0,0,1,1,0,14,10,24,1,7,4.16666666666667,29.1666666666667,41.6666666666667,58.3333333333333
"330","59","6",0,1,2,0,2,5,0,0,1,1,5,0,0,0,0,0,11,9,20,0,10,0,50,45,55
"331","6","1",9,14,19,7,14,38,14,3,14,12,33,10,11,6,3,0,119,91,210,9,71,4.28571428571429,33.8095238095238,43.3333333333333,56.6666666666667
"332","6","2",4,10,21,7,20,68,12,6,10,18,67,11,8,10,6,2,150,133,283,6,135,2.12014134275618,47.7031802120141,46.9964664310954,53.0035335689046
"333","6","3",0,2,9,4,5,54,12,6,2,11,50,14,8,10,6,4,93,107,200,4,104,2,52,53.5,46.5
"334","6","4",7,10,12,6,13,57,9,6,10,8,57,9,5,10,6,2,121,109,230,9,114,3.91304347826087,49.5652173913044,47.3913043478261,52.6086956521739
"335","6","5",0,14,25,3,22,174,13,11,14,14,170,21,7,17,11,2,264,257,521,2,344,0.383877159309021,66.0268714011516,49.3282149712092,50.6717850287908
"336","6","6",4,10,16,9,15,71,16,5,10,15,70,12,10,11,5,0,148,134,282,4,141,1.41843971631206,50,47.5177304964539,52.4822695035461
"337","60","1",0,1,2,0,2,5,6,3,1,2,5,8,1,8,3,1,21,30,51,1,10,1.96078431372549,19.6078431372549,58.8235294117647,41.1764705882353
"338","60","2",0,1,8,4,4,8,6,7,1,11,5,9,8,6,7,10,40,58,98,10,13,10.2040816326531,13.265306122449,59.1836734693878,40.8163265306122
"339","60","3",1,2,4,2,4,19,2,3,2,4,19,4,1,4,3,0,38,39,77,1,38,1.2987012987013,49.3506493506493,50.6493506493507,49.3506493506493
"340","60","4",15,5,8,2,6,10,3,4,6,5,8,5,5,3,5,3,56,40,96,18,18,18.75,18.75,41.6666666666667,58.3333333333333
"341","60","5",47,7,7,1,7,15,1,1,7,1,15,1,1,1,1,3,88,31,119,50,30,42.0168067226891,25.2100840336134,26.0504201680672,73.9495798319328
"342","60","6",28,9,8,1,6,8,2,2,9,0,6,3,3,1,2,1,66,26,92,29,14,31.5217391304348,15.2173913043478,28.2608695652174,71.7391304347826
"343","61","1",23,10,20,1,18,19,5,2,10,11,18,6,3,5,2,2,100,58,158,25,37,15.8227848101266,23.4177215189873,36.7088607594937,63.2911392405063
"344","61","2",4,10,13,5,13,9,8,5,10,7,10,8,4,9,5,7,69,61,130,11,19,8.46153846153846,14.6153846153846,46.9230769230769,53.0769230769231
"345","61","3",0,1,2,3,2,13,5,7,1,4,13,9,3,9,7,5,35,52,87,5,26,5.74712643678161,29.8850574712644,59.7701149425287,40.2298850574713
"346","61","4",0,0,0,1,0,1,0,3,0,1,1,2,1,2,3,17,5,30,35,17,2,48.5714285714286,5.71428571428571,85.7142857142857,14.2857142857143
"347","61","5",0,0,2,0,0,1,1,2,0,2,0,3,2,2,3,24,8,37,45,24,1,53.3333333333333,2.22222222222222,82.2222222222222,17.7777777777778
"348","61","6",0,0,0,0,0,1,0,1,0,0,1,1,1,1,2,29,4,36,40,29,2,72.5,5,90,10
"349","62","1",5,4,6,3,7,9,4,3,4,5,9,4,3,4,3,9,43,42,85,14,18,16.4705882352941,21.1764705882353,49.4117647058824,50.5882352941176
"350","62","2",1,1,3,3,3,9,5,3,1,4,9,5,3,5,3,3,30,34,64,4,18,6.25,28.125,53.125,46.875
"351","62","3",2,4,7,2,7,6,2,0,4,5,6,0,2,0,0,0,32,18,50,2,12,4,24,36,64
"352","62","4",8,5,7,0,6,2,1,1,5,2,1,2,1,0,1,0,31,14,45,8,3,17.7777777777778,6.66666666666667,31.1111111111111,68.8888888888889
"353","62","5",11,3,4,1,5,10,1,0,3,3,10,0,1,0,0,0,37,18,55,11,20,20,36.3636363636364,32.7272727272727,67.2727272727273
"354","62","6",3,2,2,0,1,3,1,0,3,0,2,1,1,0,0,0,15,7,22,3,5,13.6363636363636,22.7272727272727,31.8181818181818,68.1818181818182
"355","63","1",2,3,5,6,5,9,8,6,3,9,8,8,7,7,6,7,46,56,102,9,17,8.82352941176471,16.6666666666667,54.9019607843137,45.0980392156863
"356","63","2",5,5,17,4,13,30,5,6,5,16,26,7,7,4,6,5,86,78,164,10,56,6.09756097560976,34.1463414634146,47.5609756097561,52.4390243902439
"357","63","3",0,3,12,5,9,22,9,10,3,14,19,14,8,11,10,12,71,93,164,12,41,7.31707317073171,25,56.7073170731707,43.2926829268293
"358","63","4",4,5,5,2,6,14,3,1,5,2,15,2,1,2,1,1,41,31,72,5,29,6.94444444444444,40.2777777777778,43.0555555555556,56.9444444444444
"359","63","5",3,3,8,1,6,17,4,1,3,6,15,4,3,1,0,0,43,35,78,3,32,3.84615384615385,41.025641025641,44.8717948717949,55.1282051282051
"360","63","6",6,4,4,2,5,5,2,0,4,2,6,1,1,2,1,1,29,20,49,7,11,14.2857142857143,22.4489795918367,40.8163265306122,59.1836734693878
"361","64","1",5,6,10,4,8,14,12,4,6,8,12,12,7,10,5,2,65,63,128,7,26,5.46875,20.3125,49.21875,50.78125
"362","64","2",3,3,7,4,9,13,7,2,2,8,15,6,1,8,2,4,49,48,97,7,28,7.21649484536082,28.8659793814433,49.4845360824742,50.5154639175258
"363","64","3",0,3,2,4,2,6,1,9,3,3,6,6,3,6,8,36,27,74,101,36,12,35.6435643564356,11.8811881188119,73.2673267326733,26.7326732673267
"364","64","4",5,4,4,5,4,9,10,3,3,5,10,8,4,9,3,1,46,44,90,6,19,6.66666666666667,21.1111111111111,48.8888888888889,51.1111111111111
"365","64","5",11,4,5,5,5,2,6,2,4,6,3,3,5,4,3,0,42,29,71,11,5,15.4929577464789,7.04225352112676,40.8450704225352,59.1549295774648
"366","64","6",10,3,5,1,2,3,2,1,3,3,1,2,4,0,2,2,29,18,47,12,4,25.531914893617,8.51063829787234,38.2978723404255,61.7021276595745
"367","65","1",2,2,5,2,5,7,4,6,2,5,7,7,3,7,6,7,35,45,80,9,14,11.25,17.5,56.25,43.75
"368","65","2",2,2,0,2,1,2,0,8,3,0,3,6,2,7,8,7,20,36,56,9,5,16.0714285714286,8.92857142857143,64.2857142857143,35.7142857142857
"369","65","3",0,2,3,0,2,2,1,3,2,2,1,3,2,2,3,1,15,17,32,1,3,3.125,9.375,53.125,46.875
"370","65","4",16,6,8,0,5,10,2,0,5,2,8,2,2,0,0,0,49,20,69,16,18,23.1884057971014,26.0869565217391,28.9855072463768,71.0144927536232
"371","65","5",2,2,2,0,2,20,0,0,2,0,21,0,0,0,0,0,30,24,54,2,41,3.7037037037037,75.9259259259259,44.4444444444444,55.5555555555556
"372","65","6",18,3,4,0,4,0,0,0,2,1,0,0,0,0,0,0,31,4,35,18,0,51.4285714285714,0,11.4285714285714,88.5714285714286
"373","66","1",2,2,3,2,3,11,5,9,2,4,11,12,3,12,10,18,39,73,112,20,22,17.8571428571429,19.6428571428571,65.1785714285714,34.8214285714286
"374","66","2",2,4,1,5,1,9,7,11,4,2,9,13,5,13,11,29,40,89,129,31,18,24.031007751938,13.953488372093,68.9922480620155,31.0077519379845
"375","66","3",7,4,4,4,4,9,4,8,4,4,9,8,4,9,8,10,45,58,103,17,18,16.504854368932,17.4757281553398,56.3106796116505,43.6893203883495
"376","66","4",3,2,6,2,6,15,7,2,3,6,15,6,3,6,2,1,46,42,88,4,30,4.54545454545455,34.0909090909091,47.7272727272727,52.2727272727273
"377","66","5",8,4,8,3,9,10,4,3,4,7,11,5,2,6,4,4,50,45,95,12,21,12.6315789473684,22.1052631578947,47.3684210526316,52.6315789473684
"378","66","6",0,2,2,7,3,4,8,6,2,7,4,8,6,8,6,10,33,53,86,10,8,11.6279069767442,9.30232558139535,61.6279069767442,38.3720930232558
"379","67","1",0,1,4,5,4,14,6,7,1,8,14,8,5,8,7,8,43,60,103,8,28,7.76699029126214,27.1844660194175,58.252427184466,41.747572815534
"380","67","2",1,1,5,5,8,20,6,1,1,9,23,2,2,6,1,2,48,48,96,3,43,3.125,44.7916666666667,50,50
"381","67","3",0,0,3,0,3,25,1,3,0,3,25,4,0,4,3,2,37,42,79,2,50,2.53164556962025,63.2911392405063,53.1645569620253,46.8354430379747
"382","67","4",0,0,0,0,0,27,0,1,0,0,27,2,0,1,1,0,29,33,62,0,54,0,87.0967741935484,53.2258064516129,46.7741935483871
"383","67","5",0,1,1,0,0,5,3,2,1,0,4,5,1,5,3,7,13,28,41,7,9,17.0731707317073,21.9512195121951,68.2926829268293,31.7073170731707
"384","67","6",0,0,1,0,0,1,1,1,0,1,0,2,0,1,1,6,5,13,18,6,1,33.3333333333333,5.55555555555556,72.2222222222222,27.7777777777778
"385","68","1",0,3,2,1,3,0,0,1,3,0,1,0,0,1,0,4,10,12,22,4,1,18.1818181818182,4.54545454545455,54.5454545454545,45.4545454545455
"386","68","2",0,0,5,2,5,6,3,1,0,7,6,2,2,3,2,0,23,24,47,0,12,0,25.531914893617,51.063829787234,48.936170212766
"387","68","3",4,3,3,2,5,2,2,1,4,2,3,1,1,2,1,0,25,14,39,4,5,10.2564102564103,12.8205128205128,35.8974358974359,64.1025641025641
"388","68","4",0,1,1,1,0,2,1,2,1,1,1,1,2,1,2,1,9,12,21,1,3,4.76190476190476,14.2857142857143,57.1428571428571,42.8571428571429
"389","68","5",0,0,0,0,0,0,0,1,0,0,0,0,0,0,0,1,1,4,5,1,0,20,0,80,20
"390","68","6",0,0,0,0,0,3,0,0,0,0,3,0,0,0,0,0,5,4,9,0,6,0,66.6666666666667,44.4444444444444,55.5555555555556
"391","69","1",2,3,3,1,5,2,2,0,4,1,4,1,0,3,1,0,21,14,35,2,6,5.71428571428571,17.1428571428571,40,60
"392","69","2",1,1,5,3,5,5,5,3,1,7,4,5,3,4,3,11,29,40,69,12,9,17.3913043478261,13.0434782608696,57.9710144927536,42.0289855072464
"393","69","3",1,3,2,2,3,5,3,3,3,1,7,4,1,6,4,8,24,35,59,9,12,15.2542372881356,20.3389830508475,59.3220338983051,40.6779661016949
"394","69","4",0,0,1,0,0,23,2,0,0,1,22,2,1,1,0,0,28,28,56,0,45,0,80.3571428571429,50,50
"395","69","5",1,3,3,1,4,9,2,1,3,1,11,2,0,3,1,1,26,23,49,2,20,4.08163265306122,40.8163265306122,46.9387755102041,53.0612244897959
"396","69","6",0,1,3,1,2,11,3,1,1,3,10,3,2,2,1,0,24,23,47,0,21,0,44.6808510638298,48.936170212766,51.063829787234
"397","7","1",9,7,10,10,8,22,12,9,6,13,20,11,11,10,9,4,88,86,174,13,42,7.47126436781609,24.1379310344828,49.4252873563218,50.5747126436782
"398","7","2",11,9,15,8,17,12,13,4,9,14,14,9,7,11,5,1,91,71,162,12,26,7.40740740740741,16.0493827160494,43.8271604938272,56.1728395061728
"399","7","3",10,11,10,8,9,18,10,5,11,7,17,7,9,6,5,1,83,64,147,11,35,7.48299319727891,23.8095238095238,43.5374149659864,56.4625850340136
"400","7","4",6,4,10,6,8,21,11,13,4,13,19,18,9,16,13,36,81,129,210,42,40,20,19.047619047619,61.4285714285714,38.5714285714286
"401","7","5",1,3,5,7,7,27,12,7,3,9,29,12,5,15,7,9,70,91,161,10,56,6.2111801242236,34.7826086956522,56.5217391304348,43.4782608695652
"402","7","6",2,1,15,4,12,20,10,2,1,18,17,7,7,4,1,1,66,59,125,3,37,2.4,29.6,47.2,52.8
"403","8","1",11,13,16,7,17,13,9,4,13,10,15,6,6,7,4,4,92,66,158,15,28,9.49367088607595,17.7215189873418,41.7721518987342,58.2278481012658
"404","8","2",3,3,10,5,11,14,8,9,3,12,15,12,4,13,9,3,64,73,137,6,29,4.37956204379562,21.1678832116788,53.2846715328467,46.7153284671533
"405","8","3",6,5,6,8,7,22,11,8,5,9,23,12,7,12,8,7,74,85,159,13,45,8.17610062893082,28.3018867924528,53.4591194968553,46.5408805031447
"406","8","4",5,7,9,5,9,41,8,8,7,6,41,11,4,11,7,9,92,99,191,14,82,7.32984293193717,42.9319371727749,51.8324607329843,48.1675392670157
"407","8","5",2,2,4,5,5,17,7,11,2,7,19,12,4,14,11,9,55,79,134,11,36,8.2089552238806,26.865671641791,58.955223880597,41.044776119403
"408","8","6",13,6,4,3,5,6,3,3,6,1,7,3,2,3,3,2,44,29,73,15,13,20.5479452054795,17.8082191780822,39.7260273972603,60.2739726027397
"409","9","1",4,5,10,6,11,14,10,2,4,11,16,6,4,8,2,1,64,53,117,5,30,4.27350427350427,25.6410256410256,45.2991452991453,54.7008547008547
"410","9","2",7,8,10,5,10,11,3,5,8,7,11,3,6,3,6,4,61,49,110,11,22,10,20,44.5454545454545,55.4545454545455
"411","9","3",51,2,5,3,6,14,5,3,3,5,15,5,2,6,3,0,92,39,131,51,29,38.9312977099237,22.1374045801527,29.7709923664122,70.2290076335878
"412","9","4",93,3,2,0,2,1,0,0,2,0,1,0,0,0,0,0,103,4,107,93,2,86.9158878504673,1.86915887850467,3.73831775700935,96.2616822429907
"413","9","5",54,6,6,0,6,1,0,0,6,0,1,0,0,0,0,0,76,7,83,54,2,65.0602409638554,2.40963855421687,8.43373493975904,91.566265060241
"414","9","6",53,2,2,0,1,2,0,0,1,0,2,0,0,0,0,0,62,4,66,53,4,80.3030303030303,6.06060606060606,6.06060606060606,93.9393939393939
